我	wǒ 
你/妳	nǐ 
他/她	tā
我們	wǒmen 
你們/妳們	nǐmen 
他們/她們	tāmen
您	nín 
誰	shéi 
人	rén 
中國	zhōngguó 
美國	měiguó 
日本	rìběn 
台灣	táiwān
名字(ㄗ˙)	míngzi
家	jiā 
電話	diànhuà 
現在	xiànzài 
今年	jīnnián 
今天	jīntiān 
明天	míngtiān 
昨天	zuótiān 
早上	zǎoshàng
上午	shàngwǔ 
中午	zhōngwǔ 
下午	xiàwǔ 
晚上	wǎnshàng
一	yī 
二	èr 
三	sān 
四	sì 
五	wǔ 
六	liù 
七	qī 
八	bā 
九	jiǔ 
十	shí 
零	líng 
兩	liǎng 
時候	shíhòu 
百	bǎi 
半	bàn 
爸爸	bàba
媽媽	māma
哥哥	gēge
弟弟	dìdi
姊姊/姐姐	jiějie
妹妹	mèimei 
的	de 
第	dì 
分	fēn
點	diǎn
個	ge
歲	suì 
年	nián 
住	zhù 
來	lái 
是	shì 
姓	xìng 
覺得	juéde
喜歡	xǐhuān 
打電話	dǎdiànhuà 
高興	gāoxìng 
漂亮	piàoliàng
高	gāo 
好	hǎo 
很	hěn 
真	zhēn 
電腦	diànnǎo 
老師	lǎoshī 
買	mǎi 
忙	máng 
學生	xuéshēng 
大學	dàxué 
學校	xuéxiào 
字	zì 
筆	bǐ 
學	xué 
問	wèn 
說	shuō 
寫	xiě 
聽	tīng 
練習	liànxí 
能	néng 
可以	kěyǐ 
上課	shàngkè 
知道	zhīdào 
電視(機)	diànshì(jī) 
水	shuǐ 
再	zài 
書	shū 
電影	diànyǐng 
以前	yǐqián 
以後	yǐhòu 
走	zǒu 
等	děng 
看	kàn 
什麼	shénme
朋友	péngyǒu 
東西	dōngxi 
吧	ba 
呢	ne 
嗎	ma
找	zhǎo 
做	zuò 
再見	zàijiàn 
怎麼樣	zěnmeyàng 
叫	jiào 
謝謝	xièxie
對不起	duìbuqǐ 
請問	qǐngwèn 
這	zhè 
那	nà 
公共汽車/公車	gōnggòngqìchē/gōngchē 
車(子)	chē(zi) 
到	dào 
去	qù 
回	huí 
坐	zuò 
開車	kāichē 
錢	qián 
多少	duōshǎo 
給	gěi 
貴	guì 
便宜	piányí
大	dà 
小	xiǎo 
難	nán 
容易	róngyì 
有	yǒu 
想	xiǎng 
幾	jǐ 
塊	kuài 
飯	fàn 
吃	chī 
請	qǐng 
也	yě 
不	bù
沒	méi 
都	dōu 
只	zhǐ
可是	kěshì 
還是	háishì 
了	le
得	de
過	guò 
男	nán 
女	nǚ 
孩子	háizi 
小姐	xiǎojiě 
先生	xiānshēng 
太太	tàitai 
女兒	nǚér 
兒子	érzi
大家	dàjiā 
路	lù 
手機	shǒujī 
號碼	hàomǎ 
明年	míngnián 
去年	qùnián 
生日	shēngrì 
月	yuè 
日	rì 
星期	xīngqí
星期天/星期日	xīngqítiān/xīngqírì 
週末/周末	zhōumò 
號	hào 
天	tiān 
從	cóng 
在	zài 
笑	xiào 
愛	ài 
好看	hǎokàn 
快樂	kuàilè 
太	tài 
非常	fēicháng 
工作	gōngzuò 
醫生	yīshēng 
醫院	yīyuàn 
公司	gōngsī 
賣	mài 
準備	zhǔnbèi 
一點(兒)	yīdiǎn(r) 
一些	yīxiē 
本	běn 
張	zhāng 
中學	zhōngxué 
年級	niánjí 
英文	yīngwén 
紙	zhǐ 
問題	wèntí 
意思	yìsi 
圖書館	túshūguǎn 
數學	shùxué 
歷史	lìshĭ
餐廳/飯館	cāntīng/ fànguǎn
學習	xuéxí 
參加	cānjiā 
畫	huà
讀	dú 
會	huì 
有趣	yǒuqù 
為什麼	wèishénme 
下課	xiàkè 
說話	shuōhuà 
考試	kǎoshì 
懂	dǒng 
天氣	tiānqì 
房子	fángzi 
門	mén 
山	shān 
客廳	kètīng 
河	hé 
狗	gǒu 
花	huā
風	fēng 
海	hǎi 
魚	yú 
樹	shù 
開	kāi 
冷	lěng 
熱	rè 
洗澡	xǐzǎo 
咖啡	kāfēi 
茶	chá 
生活	shēnghuó 
用	yòng 
洗	xǐ 
穿	chuān 
起床	qǐchuáng 
方便	fāngbiàn 
睡覺	shuìjiào 
先	xiān 
常常	chángcháng 
每	měi 
次	cì 
音樂	yīnyuè 
票	piào 
照片	zhàopiàn 
打	dǎ 
玩	wán
跑	pǎo 
運動	yùndòng 
開始	kāishǐ 
走路	zǒulù 
唱歌	chànggē 
信	xìn 
喂(ㄨㄟˊ)/喂	wéi/wèi
介紹	jièshào 
換	huàn 
認識	rènshi 
沒關係(ㄒㄧ˙)	méiguānxi 
怎麼	zěnme 
哪	nǎ 
哪裡/哪兒	nǎlǐ/nǎr 
這裡/這兒	zhèlǐ/zhèr 
那裡/那兒	nàlǐ/nàr 
上(面)	shàng(miàn)
下(面)	xià(miàn)
外(面)	wàimiàn 
前(面)	qián(miàn) 
後(面)	hòu(miàn)
右邊	yòubiān
左邊	zuǒbiān
旁邊	pángbiān
中間	zhōngjiān 
地鐵	dìtiě 
地方	dìfāng 
附近	fùjìn 
離	lí 
往	wǎng 
送	sòng 
帶	dài 
放	fàng 
拿	ná 
過	guò 
進來	jìnlái 
出去	chūqù 
站	zhàn 
快	kuài 
慢	màn 
近	jìn 
遠	yuǎn 
手	shǒu 
身體	shēntǐ 
眼睛	yǎnjīng 
藥	yào 
累	lèi 
雙	shuāng 
元	yuán 
鞋子	xiézi 
褲子	kùzi 
市場	shìchǎng 
衣服(ㄈㄨ˙)	yīfu
比	bǐ 
要	yào 
長	cháng 
新	xīn 
一樣	yīyàng 
好吃	hǎochī 
件	jiàn 
杯	bēi 
瓶	píng 
菜	cài 
蘋果	píngguǒ 
肉	ròu 
酒	jiǔ 
喝	hē 
少	shǎo 
多	duō 
一起	yīqǐ 
因為	yīnwèi 
和	hé 
所以	suǒyǐ 
跟	gēn 
著	zhe 
可能	kěnéng 
姓名	xìngmíng 
公園	gōngyuán 
國家	guójiā 
城市	chéngshì 
街	jiē 
電子郵件	diàn​zǐ​yóu​jiàn
結婚	jiéhūn 
小時	xiǎoshí 
點鐘	diǎnzhōng
分 	fēn
分鐘	fēnzhōng
天 	tiān 
夏天	xiàtiān 
冬天	dōngtiān 
秋天	qiūtiān 
春天	chūntiān 
年輕	niánqīng 
老	lǎo 
男生	nánshēng 
女生	nǚshēng 
小孩	xiǎohái
家人	jiārén 
緊張	jǐnzhāng 
可愛	kěài 
胖	pàng 
矮	ǎi 
瘦	shòu 
千	qiān 
萬	wàn 
在 	zài 
辦公室	bàngōngshì 
工廠	gōngchăng 
工人	gōngrén 
護士	hùshì 
司機	sījī 
老闆/老板	lǎobǎn
同事	tóngshì  
上班	shàngbān 
小學	xiǎoxué 
上學	shàngxué 
作業	zuòyè 
功課	gōngkè 
請假	qǐngjià 
考試 	kǎoshì 
教室	jiàoshì 
洗手間/廁所	xǐshǒujiān/cèsuǒ
語言	yǔyán 
科學	kēxué 
華語/華文	huáyǔ/huáwén 
黑板	hēibǎn 
課本	kèběn 
句子	jùzi 
注意	zhùyì 
讀書	dúshū 
回答	huídá 
休息	xiūxí 
決定 	juédìng 
圖片	túpiàn 
畫/畫兒	huà/huàr
記得	jìdé 
房間	fángjiān 
廚房	chúfáng 
窗/窗戶	chuānghù 
樓	lóu 
樓上	lóushàng 
樓下	lóuxià 
電梯	diàntī 
家具	jiājù 
椅子	yǐzi 
桌(子)	zhuō(zi) 
沙發	shāfā 
床	chuáng 
關	guān 
冷氣(機)	lěngqì(jī) 
安靜	ānjìng 
不錯	bùcuò 
海邊	hǎibiān 
湖	hú 
馬	mǎ 
鳥	niǎo
貓	māo 
雞	jī 
太陽	tàiyáng 
下雨	xiàyǔ 
下雪	xiàxuě 
新年	xīnnián 
運動 	yùndòng 
游泳	yóuyǒng 
踢	tī 
足球	zúqiú 
籃球	lánqiú 
網球	wǎngqiú 
棒球	bàngqiú 
比賽	bǐsài 
比賽 	bǐsài 
騎	qí 
腳踏車/自行車	jiǎotàchē/zìxíngchē 
跑步	pǎobù 
電影院	diànyǐngyuàn 
表演	biǎoyǎn 
上網	shàngwǎng 
輸	shū 
贏	yíng 
有時候	yǒushíhòu 
久	jiǔ 
報紙	bàozhǐ 
不客氣	bùkèqì 
禮物	lǐwù 
歡迎	huānyíng 
晚會	wǎnhuì 
信封	xìnfēng 
寄	jì 
接	jiē 
郵局	yóujú 
銀行	yínháng 
警察	jǐngchá 
壞	huài 
幫忙	bāngmáng 
計程車	jìchéngchē 
車站	chēzhàn 
火車	huǒchē 
飛機	fēijī 
飛機場/機場	fēijīchǎng/jīchǎng 
馬路	mǎlù 
十字路口	shízìlùkǒu 
對面	duìmiàn 
裡面	lǐmiàn 
旅行	lǚxíng 
飯店	fàndiàn 
旅館	lǚguǎn 
參觀	cānguān 
地圖	dìtú 
照相機	zhàoxiàngjī 
照相	zhàoxiàng 
風景	fēngjǐng 
頭	tóu 
頭髮	tóufǎ 
耳朵	ěrduo
手指(頭)	shǒuzhǐ(tou)
肚子	dùzi 
健康	jiànkāng 
感冒	gǎnmào 
生病	shēngbìng 
受傷	shòushāng  
餓	è 
渴	kě 
舒服(ㄈㄨ˙)	shūfu
眼鏡	yǎnjìng 
痛	tòng 
希望	xīwàng 
商店	shāngdiàn 
店	diàn 
重要	zhòngyào 
給 	gěi 
公斤	gōngjīn 
顏色	yánsè 
黃色	huángsè 
白色	báisè 
襪子	wàzi 
裙子	qúnzi 
短	duǎn 
小心	xiǎoxīn 
牛奶	niúnǎi 
蛋	dàn 
餃子	jiǎozi 
麵	miàn 
湯	tāng 
包子	bāozi 
蛋糕	dàngāo 
麵包	miànbāo 
水果	shuǐguǒ 
香蕉	xiāngjiāo 
食物	shíwù 
飲料	yǐnliào 
果汁	guǒzhī 
杯子	bēizi 
多 	duō 
甜	tián 
菜單	càidān 
巧克力	qiǎokèlì 
碗	wǎn 
盤子	pánzi 
片	piàn 
一半/一半兒	yībàn/yībànr
過 	guò 
一定	yīdìng 
出生	chūshēng 
國	guó 
不同	bùtóng 
地址	dìzhǐ
市	shì
傳真	chuánzhēn 
留言	liú​yán
日期	rìqí 
時間	shíjiān 
鐘頭	zhōngtóu 
晚	wǎn 
夜	yè 
禮拜	lǐbài 
禮拜天	lǐbàitiān 
前天	qiántiān 
後天	hòutiān 
從前	cóngqián 
夏	xià 
冬	dōng 
秋	qiū 
春	chūn 
一會兒	yīhuǐér 
不久	bùjiǔ 
剛剛	gānggāng 
剛才	gāngcái 
當然	dāngrán 
自己	zìjǐ 
別人	biérén 
年紀	niánjì 
男人	nánrén 
女人	nǚrén 
大人	dàrén 
老人	lǎorén 
習慣	xíguàn 
習慣 	xíguàn 
家庭	jiātíng 
父親	fùqīn 
母親	mǔqīn 
父母	fùmŭ 
爺爺	yéye
奶奶	nǎinai 
關係	guānxì 
教堂	jiàotáng 
好 	hǎo 
真 	zhēn 
最	zuì 
更	gèng 
愉快	yúkuài 
開心	kāixīn 
著急	zhāojí 
擔心	dānxīn 
生氣	shēngqì 
怕	pà 
哭	kū 
難過	nánguò 
傷心	shāngxīn 
美	měi 
美麗	měilì 
聰明	cōngmíng 
認真	rènzhēn 
勇敢	yŏnggăn 
禮貌	lĭmào 
害羞	hàixiū 
應該	yīnggāi 
相信	xiāngxìn 
經驗 	jīngyàn 
關心	guānxīn 
辛苦	xīnkǔ 
願意	yuànyì 
心情	xīnqíng 
幸福	xìngfú 
可憐	kělián 
差	chà 
職業	zhíyè 
教師	jiàoshī 
經理	jīnglǐ 
記者	jìzhě 
服務員/服務生	fú​wù​yuán/fúwùshēng 
顧客	gùkè 
教書	jiāoshū 
開會	kāihuì 
下班	xiàbān 
危險	wéixiǎn 
安全	ānquán 
安全 	ānquán 
成功	chénggōng 
報告	bàogào 
報告 	bàogào 
打算	dǎsuàn 
機會	jīhuì 
當	dāng 
如果	rúguǒ 
計畫/劃 	jìhuà
計畫	jìhuà 
努力	nǔlì 
管理	guănlǐ 
學院	xuéyuàn 
小學生	xiăoxuéshēng 
大學生	dàxuéshēng 
同學	tóngxué 
校長	xiàozhǎng 
放假	fàngjià
畢業	bìyè 
開學	kāixué 
成績	chéngjī 
學期	xuéqí 
學費	xuéfèi 
暑假	shŭjià 
寒假	hánjià 
服務	fúwù 
宿舍	sùshè
操場	cāochăng 
校園	xiàoyuán 
中文	zhōngwén 
文化	wénhuà 
語法	yǔfǎ 
漢語	hànyǔ 
書法	shūfă 
班	bān 
班 	bān 
書桌	shūzhuō 
課	kè 
字典	zìdiǎn 
漢字	hànzì 
鉛筆	qiānbǐ 
尺	chǐ 
毛筆	máobĭ 
教	jiào 
講	jiǎng 
講話	jiǎnghuà 
告訴	gàosù 
念/唸	niàn 
練習 	liànxí 
討論	tǎolùn 
認為	rènwéi 
解釋	jiěshì 
同意	tóngyì 
了解/瞭解	liǎojiě 
清楚	qīngchǔ 
無聊	wúliáo 
決定	juédìng 
遍	biàn 
交	jiāo 
借	jiè 
算	suàn 
對	duì 
錯	cuò 
辦法	bànfǎ 
方法	fāngfǎ 
有用	yǒuyòng 
進步	jìnbù 
忘	wàng 
記	jì 
公寓	gōngyù 
大樓	dàlóu 
臥室	wòshì 
花園	huāyuán 
門口	ménkǒu 
浴室	yùshì 
樓梯	lóutī 
牆	qiáng 
洗衣機	xǐyījī 
冰箱	bīngxiāng 
燈	dēng 
打開	dǎkāi 
盒子	hézi
鄰居	línjū 
熱鬧	rènào 
吵	chǎo 
滿意	mǎnyì 
乾淨	gānjìng 
房租	fángzū 
租	zū 
開水	kāishuǐ 
鄉下	xiāngxià 
森林	sēnlín 
地	dì 
草	cǎo 
枝	zhī 
隻	zhī 
動物	dòngwù 
牛	niú 
虎	hŭ 
羊	yáng 
豬	zhū 
月亮	yuèliàng 
星星	xīngxīng 
雲	yún 
地球	dìqiú 
世界	shìjiè 
環境	huánjìng 
火	huǒ 
晴天	qíngtiān 
暖和	nuǎnhuo 
涼快	liángkuài 
溫暖	wēnnuăn 
度	dù 
溫度	wēndù 
雨	yǔ 
雪	xuě 
空氣	kōngqì 
間	jiān 
睡	shuì 
發生	fāshēng 
發現	fāxiàn 
發現 	fāxiàn 
照顧	zhàogù 
打掃	dǎsǎo 
餐	cān 
起來	qǐlái 
搬	bān 
掛	guà 
有空/有空兒	yǒukòng/yǒukòngr
過年	guònián 
結束	jiéshù 
完	wán 
散步	sànbù 
爬	pá 
跳	tiào 
座位	zuòwèi 
博物館	bówùguăn 
節目	jiémù 
新聞	xīnwén 
政治	zhèngzhì 
體育	tǐyù 
網站	wǎngzhàn 
還	hái 
經常	jīngcháng 
平常	píngcháng 
總是	zǒngshì 
已經	yǐjīng 
各	gè 
雜誌	zázhì 
文章	wénzhāng 
故事	gùshì 
小說	xiǎoshuō 
美術	měishù 
藝術	yìshù 
興趣	xìngqù 
收	shōu 
談	tán 
聊天/聊天兒	liáotiān/liáotiānr
唱	chàng 
歌	gē
早	zǎo 
遲到	chídào 
後來	hòulái 
變	biàn 
跳舞	tiàowǔ 
樂器	yuèqì 
吉他	jítā 
鋼琴	gāngqín 
可怕	kěpà 
活動	huódòng 
就	jiù 
消息	xiāoxí 
才	cái 
又	yòu 
客人	kèrén 
不好意思	bùhǎoyìsi 
怎麼了	zěnmele 
怎麼辦	zěnmebàn 
客氣	kèqì 
舞會	wŭhuì 
最近	zuìjìn 
請客	qǐngkè 
慶祝	qìngzhù 
聽說	tīngshuō 
感謝	gǎnxiè 
見面	jiànmiàn 
約	yuē 
事	shì 
事情	shìqíng 
明信片	míngxìnpiàn 
卡片	kǎpiàn 
幫	bāng 
弄	nòng 
檢查	jiǎnchá 
通知	tōngzhī 
通知 	tōngzhī 
叫 	jiào 
麻煩	máfán 
偷	tōu 
錢包	qiánbāo 
拉	lā 
小偷	xiǎotōu 
滿	mǎn 
丟	diū 
啊	ā 
汽車	qìchē 
輛	liàng 
船/船兒	chuán/chuánr
停車場	tíngchēchăng 
搭	dā 
起飛	qĭfēi 
出	chū 
出來	chūlái 
進	jìn 
進去	jìnqù 
回去	huíqù 
路口	lùkǒu 
紅綠燈	hónglǜdēng 
橋	qiáo 
左	zuǒ
右	yòu
裡	lǐ 
下 	xià 
上 	shàng 
這邊	zhèbiān 
這些	zhèxiē 
那些	nàxiē 
那邊	nàbiān 
旅遊	lǚyóu 
動物園	dòngwùyuán 
出發	chūfā 
離開	líkāi 
向	xiàng 
南	nán
南部	nánbù 
南邊	nánbiān
西	xī
西部	xībù 
西邊	xībiān
北	běi
北部	běibù 
北邊	běibiān
東	dōng
東部	dōngbù
東邊	dōngbiān
經過	jīngguò 
轉	zhuǎn 
掉	diào 
一直	yīzhí 
過去	guòqù 
最後	zuìhòu 
動	dòng 
躺	tǎng 
起	qǐ 
停	tíng 
中心	zhōngxīn 
外國	wàiguó 
護照	hùzhào 
行李	xínglĭ
出口	chūkŏu 
油	yóu 
鑰匙	yàoshi 
袋子	dàizi 
公里	gōnglǐ 
方向	fāngxiàng 
出現	chūxiàn 
交通	jiāotōng 
臉	liǎn 
腿	tuǐ 
腳	jiǎo 
心	xīn 
鼻(子)	bí(zi)
背	bèi 
嘴巴	zuǐba
脖子	bózi 
健康 	jiànkāng 
感覺	gǎnjué 
感覺 	gǎnjué 
救護車	jiùhùchē
咳嗽	késòu 
發燒	fāshāo 
疼	téng 
保險	băoxiăn 
病	bìng 
看病	kànbìng 
病人	bìngrén 
掛號	guàhào 
牙刷	yáshuā 
剪	jiăn 
藥房	yàofáng 
恢復	huīfù 
救命	jiùmìng
影響 	yǐngxiǎng 
影響	yǐngxiǎng 
飽	bǎo 
吃飽	chībǎo 
簡單	jiǎndān 
書店	shūdiàn 
超級市場/超市	chāojíshìchǎng/chāoshì 
戴	dài 
試	shì 
輕	qīng 
重	zhòng 
流行	liúxíng 
藍色	lánsè 
綠色	lǜsè 
紅色	hóngsè 
黑色	hēisè 
手錶/錶	shǒubiǎo/biǎo
付	fù 
襯衫	chènshān 
毛衣	máoyī 
大衣	dàyī 
牛仔褲	niúzǎikù 
雨衣	yŭyī 
內衣	nèiyī 
帽子	màozi 
皮包	píbāo 
外套	wàitào 
乾	gān 
舊	jiù 
價格	jiàgé 
價錢	jiàqián 
排隊	páiduì  
信用卡	xìnyòngkǎ 
毛	máo 
比較	bǐjiào 
樣子	yàngzi
特別	tèbié 
一般	yībān 
圓	yuán 
光	guāng 
看見	kànjiàn 
其他	qítā
聲音	shēngyīn 
大聲	dàshēng 
好像	hǎoxiàng 
像	xiàng 
奇怪	qíguài 
死	sǐ 
髒	zāng 
差不多	chàbùduō 
一共	yīgòng 
需要	xūyào 
牛排	niúpái 
米	mǐ 
三明治	sānmíngzhì 
西瓜	xīguā 
啤酒	píjiǔ 
紅茶	hóngchá 
點菜	diǎncài 
包	bāo 
酸	suān 
苦	kǔ 
鹹	xián 
辣	là 
點心	diǎnxīn 
冰淇淋	bīngqílín 
餅乾	bǐnggān 
漢堡	hànbǎo 
青菜	qīngcài 
鹽	yán 
糖	táng 
煮	zhǔ 
碗 	wǎn 
盤	pán 
條	tiáo 
位	wèi 
種	zhǒng 
口	kǒu 
夠	gòu 
任何	rènhé 
味道	wèidào 
香	xiāng 
全部	quánbù 
所有	suǒyǒu 
許多	xǔduō 
新鮮	xīnxiān 
烤	kǎo 
嚐	cháng 
裝	zhuāng 
刀(子)	dāo(zi)
叉(子)	chā(zi)
湯匙	tāngchí 
筷子	kuàizi 
沒有	méi(yǒu) 
別	bié 
不用	bùyòng 
不但	bùdàn 
只好	zhǐhǎo 
正在	zhèngzài 
馬上	mǎshàng 
把	bǎ 
被	bèi 
讓	ràng 
或	huò 
或是	huòshì 
可能 	kěnéng 
然後	ránhòu 
但是	dànshì 
而且	érqiě 
雖然	suīrán 
原來	yuánlái 
也許	yěxǔ 
為了	wèile 
必須	bìxū 
永遠	yǒngyuǎn 
邊/邊兒	biān/biānr
那麼	nàme
這麼	zhème
本來	běnlái 
要是	yàoshì 
阿姨	āyí
哎	āi 
唉	āi 
愛	ài 
愛情	àiqíng 
愛惜	àixí 
愛心	àixīn 
安定	āndìng 
安排	ānpái 
安排	ānpái 
安心	ānxīn 
按	àn 
按照	ànzhào 
巴士	bāshì 
把	bǎ 
把握	băwò 
白	bái 
白	bái 
白(白)	bái(bái)
白菜	báicài 
白天	báitiān 
擺	băi 
百貨公司	băihuògōngsī
班機	bānjī 
搬家	bānjiā 
辦	bàn 
辦理	bànlĭ
半天	bàntiān 
半夜	bànyè 
幫助	bāngzhù 
榜樣	băngyàng 
棒	bàng
包	bāo 
包含	bāohán 
寶貝	băobèi
寶貴	băoguì 
保護	băohù 
保守	băoshǒu 
保養	băoyăng 
保證/証	băozhèng 
保證/証	băozhèng 
抱	bào
抱怨	bàoyuàn 
報名	bàomíng 
背包	bēibāo 
北方	běifāng 
被動	bèidòng 
背後	bèihòu 
背景	bèijĭng 
輩子	bèizi 
本	běn 
本人	běnrén 
本子	běnzi
笨	bèn 
逼	bī 
筆	bĭ
比	bǐ 
比如(說)	bǐrú(shuō)
畢竟	bìjìng 
避免	bìmiăn 
必要	bìyào 
鞭炮	biānpào 
變	biàn 
變成	biànchéng 
變更	biàngēng 
變化	biànhuà 
變化	biànhuà 
便條	biàntiáo 
標準	biāozhŭn 
標準	biāozhŭn 
表	biǎo 
表達	biăodá 
表面	biăomiàn 
表示	biăoshì 
表現	biǎoxiàn 
表現	biǎoxiàn 
表演	biǎoyǎn 
別的	biéde
冰	bīng 
冰塊/冰塊兒	bīngkuài/bīngkuàir
餅	bǐng 
病	bìng 
伯伯	bóbo 
博士	bóshì 
播	bò 
不必	búbì 
不斷	búduàn 
不斷	búduàn 
不過	búguò 
不過	búguò 
不見(了)	bújiàn(le)
不論	búlùn 
不幸	búxìng 
不用說	búyòngshuō 
不得不	bùdébù 
不得了	bùdéliăo 
不管	bùguǎn 
不滿	bùmăn 
不如	bùrú 
不少	bùshǎo 
不少	bùshǎo 
不足	bùzú 
部	bù 
部分/份	bùfèn
部分/份	bùfèn
部門	bùmén 
布	bù 
布/佈置	bùzhì 
擦	cā
猜	cāi
材料	cáiliào 
採用	căiyòng 
餐	cān
餐桌	cānzhuō
參考	cānkăo 
草地	cǎodì
草原	cǎoyuán 
層	céng 
曾	céng 
曾經	céngjīng 
差別	chābié 
差異	chāyì 
查	chá 
差(一)點/差(一)點兒	chà(yì)diăn/chà(yì)diănr
產品	chǎnpǐn 
產生	chănshēng 
常	cháng
嘗/嚐試	chángshì 
場	chǎng 
超過	chāoguò 
超級	chāojí 
炒	chăo 
吵	chăo
吵架	chăojià 
車禍	chēhuò 
趁	chèn 
成	chéng 
成果	chéngguǒ 
成就	chéngjiù 
成熟	chéngshú
成長	chéngzhăng 
程度	chéngdù 
承認	chéngrèn 
誠實	chéngshí 
吃喝玩樂	chīhēwánlè 
尺	chǐ 
充實	chōngshí 
重新	chóngxīn 
蟲(子)	chóng(zi)
抽	chōu 
醜	chŏu
臭	chòu 
初	chū 
出版	chūbăn 
出差	chūchāi 
出門	chūmén 
出租	chūzū 
除了	chúle 
除夕	chúxì 
廚師	chúshī 
處理	chŭlĭ
傳統	chuántŏng 
串	chuàn 
創造	chuàngzào 
吹	chuī
春節	chūnjié 
詞	cí 
此	cĭ
刺激	cìjī 
刺激	cìjī 
從不	cóngbù 
從來	cónglái 
從小	cóngxiăo 
醋	cù 
存	cún 
存在	cúnzài 
寸	cùn 
錯	cuò 
錯誤	cuòwù 
挫折	cuòzhé 
答應	dāyìng 
達成	dáchéng 
打工	dăgōng 
打架	dăjià 
打聽	dătīng 
打仗	dăzhàng 
打折	dăzhé 
大大	dàdà 
大多數	dàduōshù 
大方	dàfāng 
大概	dàgài 
大會	dàhuì 
大陸	dàlù 
大門	dàmén 
大小	dàxiăo 
大約	dàyuē 
袋	dài 
代表	dàibiǎo 
代表	dàibiǎo 
代替	dàitì 
帶來	dàilái 
帶領	dàilĭng 
單純	dānchún 
單身	dānshēn 
擔任	dānrèn 
但	dàn 
淡	dàn 
當	dāng 
當場	dāngchăng 
當地	dāngdì 
當面	dāngmiàn 
當年	dāngnián 
當天	dāngtiān 
當中	dāngzhōng 
當作	dāngzuò 
當做	dāngzuò 
倒	dǎo 
島	dăo 
導演	dăoyăn 
到	dào
到	dào
到處	dàochù 
到底	dàodĭ
到底	dàodǐ 
道德	dàodé 
道教	Dàojiào
道理	dàolǐ 
道歉	dàoqiàn 
倒	dào 
倒是	dàoshì 
得	dé 
得到	dédào 
得意	déyì 
得很	dehěn 
的話	dehuà 
得	děi
燈光	dēngguāng 
等	děng 
等/等等	děng/děngděng
等待	děngdài 
低	dī
敵人	dírén 
底	dǐ 
底下	dǐxià 
抵達	dĭdá 
地	dì 
地板	dìbăn 
地帶	dìdài 
地點	dìdiăn 
地理	dìlĭ 
地區	dìqū 
地攤	dìtān 
地位	dìwèi 
地下	dìxià 
地形	dìxíng 
點	diăn
點	diăn
點	diǎn 
點/點兒	diǎn/diǎnr
電	diàn 
電車	diànchē 
電池	diànchí 
電燈	diàndēng
店員	diànyuán 
調查	diàochá 
訂	dìng 
丟	diū 
東北	dōngběi 
東方	dōngfāng 
東南	dōngnán 
懂事	dǒngshì 
逗	dòu 
豆腐	dòufŭ 
豆漿	dòujiāng 
都市	dūshì 
毒品	dúpǐn 
獨特	dútè 
讀者	dúzhě 
段	duàn 
堆	duī 
對	duì 
對	duì 
對	duì 
對方	duìfāng 
對話	duìhuà 
對了	duìle
對象	duìxiàng 
多多少少	duōduōshăoshăo 
多麼	duóme 
朵	duǒ
頓	dùn 
嗯	ēn 
而	ér 
兒童	értóng 
發	fā
發表	fābiăo 
發財	fācái 
發出	fāchū 
發達	fādá 
發揮	fāhuī 
發覺	fājué 
發明	fāmíng 
發明	fāmíng 
發脾氣	fāpíqì 
發票	fāpiào 
法律	fălǜ
翻	fān 
翻譯	fānyì 
煩惱	fánnăo 
反而	fănér 
反應	fănyìng 
犯	fàn 
範圍	fànwéi 
方面	fāngmiàn 
方式	fāngshì 
房東	fángdōng 
房客	fángkè 
房屋	fángwū 
訪問	fǎngwèn 
放心	fàngxīn 
非	fēi 
非	fēi 
飛	fēi 
費用	fèiyòng 
分開	fēnkāi 
份	fèn 
封	fēng
豐富	fēngfù 
風格	fēnggé 
風俗	fēngsú 
佛教	Fójiào
否則	fŏuzé 
夫婦	fūfù 
符合	fúhé 
福利	fúlì 
服裝	fúzhuāng 
腐敗	fŭbài 
付出	fùchū 
負擔	fùdān 
負擔	fùdān 
負責	fùzé 
複習	fùxí 
該	gāi 
改	gǎi 
改變	gǎibiàn 
改變	gǎibiàn 
改進	găijìn 
改善	găishàn 
改天	găitiān 
蓋	gài 
概念	gàiniàn 
敢	gǎn 
趕	găn 
趕快	gǎnkuài 
趕上	gănshàng 
感動	găndòng 
感想	gănxiăng 
感興趣	gănxìngqù 
剛	gāng 
高速	gāosù 
高中	gāozhōng 
搞	găo 
歌曲	gēqŭ  
歌星	gēxīng 
隔壁	gébì 
革命	gémìng 
個人	gèrén 
個子	gèzi 
各式各樣	gèshìgèyàng 
各位	gèwèi 
個	ge
給	gěi
跟	gēn 
跟	gēn 
根	gēn 
根	gēn 
根據	gēnjù 
更加	gèngjiā 
公尺	gōngchǐ 
公分	gōngfēn 
公共	gōnggòng 
公克	gōngkè 
公路	gōnglù 
功夫	gōngfu 
功能	gōngnéng 
工具	gōngjù 
工業	gōngyè 
工作	gōngzuò
恭喜	gōngxǐ
共	gòng 
共同	gòngtóng 
貢獻	gòngxiàn 
貢獻	gòngxiàn 
溝通	gōutōng 
夠	gòu 
夠	gòu 
購買	gòumăi 
姑娘	gūniáng 
古	gŭ 
古代	gŭdài 
古蹟	gŭjī 
古老	gŭlăo 
顧	gù 
故意	gùyì 
刮	guā 
乖	guāi
怪	guài 
怪	guài 
關	guān 
觀察	guānchá 
觀點	guāndiăn 
觀念	guānniàn 
觀眾	guānzhòng 
管	guăn 
罐	guàn 
廣播	guǎngbò 
廣播	guǎngbò 
廣場	guăngchăng 
廣告	guănggào 
逛	guàng 
逛街	guàngjiē 
規矩	guījŭ 
規模	guīmó 
鬼	guǐ 
貴姓	guìxìng
櫃子	guìzi 
國內	guónèi 
國外	guówài 
國王	guówáng 
國語	guóyŭ 
過	guò
過去	guòqù
過日子	guòrìzi 
嗨	hāi 
還	hái 
還好	háihăo  
還是	háishì 
還要	háiyào  
海報	hăibào  
海灘	hăitān  
海洋	hǎiyáng 
害	hài 
害怕	hàipà
行	háng 
航空	hángkōng 
好	hăo 
好處	hǎochù 
好好/好好兒	hǎohǎo/hǎohǎor
好幾	hǎojǐ 
好了	hǎole 
好些	hǎoxiē 
和	hé 
盒	hé 
合	hé 
合唱	héchàng 
合作	hézuò 
黑	hēi
恨	hèn 
恨不得	hènbùdé 
紅	hóng
紅包	hóngbāo
紅豆	hóngdòu 
厚	hòu 
後	hòu 
後	hòu 
忽然	hūrán 
糊塗	hútú 
互相	hùxiāng 
花	huā 
花心	huāxīn
滑雪	huáxuě
畫家	huàjiā
話說回來	huàshuōhuílái 
話題	huàtí 
化妝品	huàzhuāngpĭn 
壞處	huàichù 
還	huán
環保	huánbăo 
黃	huáng
回	huí 
回答	huídá 
回想	huíxiăng 
會	huì 
會場	huìchăng 
會話	huìhuà 
會議	huìyì 
婚禮	hūnlǐ 
婚姻	hūnyīn 
混亂	hùnluàn 
活	huó 
活動	huódòng 
或許	huòxŭ 
基本	jīběn 
基本	jīběn 
基礎	jīchŭ  
基督教	Jīdūjiào
激動	jīdòng 
激烈	jīliè  
積極	jījí  
機器	jīqì
及	jí 
急	jí 
極	jí 
極了	jíle 
擠	jǐ 
擠	jǐ 
既	jì 
記	jì 
記錄	jìlù 
記錄	jìlù  
記憶	jìyì 
季節	jìjié 
紀念	jìniàn  
紀念	jìniàn  
技巧	jìqiăo  
繼續	jìxù 
加	jiā
加強	jiāqiáng 
加入	jiārù 
加上	jiāshàng 
加油	jiāyóu 
家	jiā 
家鄉	jiāxiāng 
家長	jiāzhăng 
假	jiă 
假如	jiărú 
假裝	jiăzhuāng 
架	jià 
假日	jiàrì 
價值	jiàzhí 
肩膀	jiānbăng 
堅持	jiānchí 
堅強	jiānqiáng 
減	jiăn 
減輕	jiănqīng 
減少	jiănshăo 
簡直	jiănzhí 
見	jiàn 
建立	jiànlì 
建設	jiànshè 
建設	jiànshè 
建議	jiànyì 
建議	jiànyì 
將來	jiānglái 
講價	jiăngjià 
講究	jiăngjiù 
獎學金	jiăngxuéjīn 
降低	jiàngdī 
醬油	jiàngyóu 
交	jiāo 
交流	jiāoliú 
交友	jiāoyǒu 
驕傲	jiāoào 
郊區	jiāoqū 
角度	jiăodù 
角/角色	jiăo/juésè
叫	jiào 
叫	jiào 
較	jiào 
教	jiào 
教材	jiàocái 
教導	jiàodăo 
教法	jiàofă 
教練	jiàoliàn 
教授	jiàoshòu 
教訓	jiàoxùn 
教育	jiàoyù 
教育	jiàoyù 
接觸	jiēchù 
接受	jiēshòu 
接著	jiēzhe 
結	jié 
結果	jiéguǒ 
結局	jiéjú 
節	jié 
節日	jiérì 
解決	jiějué
解釋	jiěshì 
姊妹	jiěmèi 
斤	jīn
金(子)	jīn(zi)
緊	jǐn 
僅	jĭn 
儘管	jĭnguăn 
盡	jìn 
進	jìn 
進行	jìnxíng 
進一步	jìnyíbù  
經	jīng 
經費	jīngfèi 
經過	jīngguò 
經過	jīngguò  
經驗	jīngyàn 
精神	jīngshén 
驚訝	jīngyà  
酒吧	jiŭbā 
救	jiù 
舅舅	jiùjiu 
舅媽	jiùmā
就	jiù 
就是	jiùshì 
就算	jiùsuàn 
就要	jiùyào
居住	jūzhù 
橘子	júzi 
舉	jǔ 
舉辦	jŭbàn 
舉手	jŭshŏu
舉行	jǔxíng 
句	jù 
聚	jù 
劇本	jùběn 
劇情	jùqíng 
拒絕	jùjué 
距離	jùlí 
具有	jùyŏu 
絕對	juéduì 
軍隊	jūnduì 
軍人	jūnrén 
卡車	kǎchē 
開放	kāifàng 
開花	kāihuā 
開朗	kāilăng 
開始	kāishǐ 
開玩笑	kāiwánxiào 
看不起	kànbùqĭ
看法	kànfǎ 
看起來	kànqĭlái
考	kǎo 
棵	kē
刻	kē 
科	kē 
科技	kējì 
科學	kēxué 
可	kě 
可	kě 
可靠	kěkào 
可樂	kělè
可惡	kěwù 
可惜	kěxí 
可以	kěyǐ 
渴望	kěwàng 
克	kè 
克服	kèfú 
課程	kèchéng 
課堂	kètáng 
課文	kèwén
客滿	kèmăn 
刻	kè 
肯	kěn 
肯定	kěndìng 
空	kōng 
空間	kōngjiān 
空軍	kōngjūn 
恐怕	kǒngpà 
空	kòng 
口	kǒu 
口袋	kǒudài 
口味	kŏuwèi  
誇張	kuāzhāng 
快	kuài
快要	kuàiyào 
寬	kuān 
況且	kuàngqiě 
困難	kùnnán 
困難	kùnnán 
擴大	kuòdà 
拉肚子	lādùzi 
啦	la
來	lái 
來	lái 
來不及	láibùjí 
來得及	láidejí  
藍	lán 
浪漫	làngmàn 
老公	lăogōng 
老虎	lăohŭ 
老婆	lăopó 
老實	lăoshí 
老是	lăoshì 
樂	lè 
樂觀	lèguān 
樂趣	lèqù 
垃圾	lèsè 
淚	lèi 
類	lèi 
冷淡	lěngdàn 
離	lí 
離婚	líhūn 
里	lǐ 
裡/裏	lĭ/lĭ
裡邊	lĭbiān
理解	lĭjiě 
理論	lĭlùn 
理想	lĭxiăng 
理想	lĭxiăng 
裏面	lǐmiàn
禮堂	lĭtáng 
力	lì 
力量	lìlìàng
厲害	lìhài 
立刻	lìkè 
例如	lìrú 
例子	lìzi 
利益	lìyì 
利用	lìyòng 
連	lián 
連	lián 
連/聯絡	liánluò 
連續劇	liánxùjù 
練	liàn 
戀愛	liànài 
涼	liáng
良好	liánghăo 
亮	liàng
聊	liáo 
了不起	liăobùqĭ
靈魂	línghún 
零錢	língqián 
零用錢	língyòngqián 
領	lǐng 
領導	lĭngdăo 
領域	lĭngyù 
令	lìng 
流	liú 
流汗	liúhàn 
流血	liúxiě 
留學	liúxué 
留學生	liúxuéshēng 
龍	lóng 
錄	lù 
錄取	lùqŭ  
錄音	lùyīn 
露營	lùyíng  
亂	luàn
輪胎	lúntāi 
旅客	lǚkè 
綠	lǜ
律師	lǜshī 
麻煩	máfán
馬桶	mătŏng 
碼頭	mătou 
螞蟻	măyĭ
罵	mà 
嘛	ma 
滿	măn 
滿	măn 
滿足	mănzú  
慢慢	mànmàn
慢跑	mànpăo 
慢用	mànyòng 
毛	máo 
毛病	máobìng 
貿易	màoyì 
沒	méi
沒	méi
沒什麼	méishénme 
沒想到	méixiăngdào 
玫瑰(ㄍㄨㄟ˙)	méigui 
每	měi 
美好	měihăo 
門	mén 
夢	mèng 
迷路	mílù 
迷人	mírén 
米飯	mǐfàn 
米粉	mĭfěn 
秘/祕密	mìmì 
密切	mìqiè 
免費	miănfèi 
面	miàn 
面	miàn 
面積	miànjī 
面前	miànqián 
麵條	miàntiáo 
描寫	miáoxiě 
秒	miǎo 
廟	miào 
民國	mínguó 
民族	mínzú 
名	míng 
名詞	míngcí 
明白	míngbái 
明顯	míngxiăn 
明星	míngxīng 
命	mìng 
摸	mō 
摩托車/機車	mótuōchē/jīchē
陌生	mòshēng 
某	mŏu
木	mù 
木頭	mùtou
目的	mùdì 
目前	mùqián 
拿手	náshŏu 
哪裡/哪兒	nǎlǐ/nǎr
哪些	nǎxiē 
那	nà
那裡	nàlǐ
那麼	nàme
那樣	nàyàng
那樣	nàyàng
哪	na
奶	nǎi 
奶茶	nǎichá 
耐心	nàixīn 
南方	nánfāng 
難怪	nánguài 
難看	nánkàn 
腦	năo 
腦子	năozi 
鬧鐘	nàozhōng 
內	nèi 
內容	nèiróng 
能	néng 
能夠	nénggòu 
能力	nénglì 
年	nián 
年代	niándài 
年齡	niánlíng 
年年	niánnián 
念書	niànshū 
農業	nóngyè  
女士	nǚshì 
喔	ō 
哦	ó 
噢	òu 
拍	pāi 
排	pái 
牌子	páizi 
盼望	pànwàng 
旁	páng 
陪	péi 
培養	péiyăng 
配	pèi 
配合	pèihé 
碰	pèng 
碰到	pèngdào 
碰上	pèngshàng 
批評	pīpíng 
皮	pí 
皮帶	pídài 
皮膚	pífū 
皮鞋	píxié 
篇	piān 
騙子	piànzi 
品質	pĭnzhí 
坪	píng 
平	píng 
平安	píngān 
平等	píngděng 
平時	píngshí 
平原	píngyuán 
瓶子	píngzi
破	pò
破壞	pòhuài 
葡萄	pútáo 
普遍	pŭbiàn 
欺負	qīfù 
其次	qícì 
其實	qíshí 
其中	qízhōng 
期	qí
期間	qíjiān 
起	qĭ
起	qĭ
起來	qĭlái 
氣	qì 
氣	qì 
氣溫	qìwēn 
汽水	qìshuǐ
企業	qìyè 
簽名	qiānmíng 
簽證	qiānzhèng 
謙虛	qiānxū 
前	qián 
前	qián 
前年	qiánnián 
淺	qiǎn 
強盜	qiángdào 
強調	qiángdiào 
搶	qiǎng 
親	qīn
親切	qīnqiè
親手	qīnshŏu  
親眼	qīnyăn 
親自	qīnzì 
清	qīng 
青年	qīngnián 
青少年	qīngshàonián  
輕鬆	qīngsōng  
晴	qíng 
情	qíng 
情人	qíngrén  
情況	qíngkuàng 
情形	qíngxíng 
請教	qĭngjiào 
請求	qĭngqiú 
窮	qióng 
求	qiú 
球	qiú
球場	qiúchăng 
球賽	qiúsài 
球員	qiúyuán 
取代	qŭdài 
去	qù 
去	qù 
去世	qùshì 
全	quán 
全球	quánqiú 
全身	quánshēn 
缺點	quēdiăn 
卻	què 
確定	quèdìng 
確認	quèrèn 
讓	ràng
熱狗	règŏu
熱水	rèshuǐ 
人家	rénjiā 
人間	rénjiān 
人口	rénkǒu 
人類	rénlèi 
人們	rénmen 
人民	rénmín 
人人	rénrén 
人數	rénshù 
人物	rénwù 
忍	rěn 
忍耐	rěnnài 
認	rèn 
認得	rèndé 
任務	rènwù 
扔	rēng 
仍	réng 
仍然	réngrán 
日出	rìchū 
日記	rìjì 
日子	rìzi
如	rú 
如此	rúcǐ 
如下	rúxià 
如意	rúyì 
弱	ruò 
傘	sǎn
殺	shā 
曬	shài 
山區	shānqū 
傷害	shānghài 
商品	shāngpĭn 
商人	shāngrén 
商業	shāngyè 
上	shàng 
上	shàng 
上當	shàngdàng 
上帝	shàngdì 
上街	shàngjiē 
上衣	shàngyī 
燒	shāo 
少	shǎo 
蛇	shé 
設備	shèbèi 
設計	shèjì 
設計	shèjì 
深	shēn 
深入	shēnrù 
身邊	shēnbiān 
身高	shēngāo 
身上	shēnshàng 
甚至	shènzhì 
升	shēng 
聲	shēng 
聲調	shēngdiào 
生	shēng 
生產	shēngchăn 
生動	shēngdòng 
生活	shēnghuó
生命	shēngmìng 
生意	shēngyì 
生字	shēngzì 
省	shěng 
省錢	shěngqián 
剩	shèng 
剩下	shèngxià 
濕	shī 
失戀	shīliàn 
失去	shīqù 
獅子	shīzi 
十分	shífēn 
石頭	shítou
石油	shíyóu 
時	shí 
時代	shídài 
時刻	shíkè 
實話	shíhuà 
實際	shíjì 
實力	shílì 
實行	shíxíng 
實在	shízài 
使得	shĭde 
使用	shǐyòng 
事實	shìshí 
事業	shìyè 
適應	shìyìng 
市長	shìzhăng 
收穫	shōuhuò 
收音機	shōuyīnjī 
熟	shóu 
首	shǒu
手套	shŏutào
手續	shŏuxù  
受得了	shòudeliăo  
書包	shūbāo
書架	shūjià 
蔬菜	shūcài 
舒適	shūshì 
叔叔	shúshu
熟悉	shúxī 
數	shŭ
數字	shùzì 
樹木	shùmù 
刷牙	shuāyá
帥	shuài 
雙	shuāng 
水餃	shuǐjiǎo 
水平	shuĭpíng 
水準	shuĭzhŭn 
睡著	shuìzháo 
順便	shùnbiàn 
順利	shùnlì 
說法	shuōfă 
說明	shuōmíng 
說明	shuōmíng 
說起來	shuōqĭlái 
思考	sīkăo 
思想	sīxiăng 
似乎	sìhū 
寺廟	sìmiào 
速度	sùdù 
算了	suànle 
隨便	suíbiàn
隨時	suíshí 
所	suǒ 
所	suŏ 
所謂	suŏwèi  
它	tā 
它們	tāmen 
台	tái 
抬	tái 
颱風	táifēng 
態度	tàidù 
談話	tánhuà 
堂	táng 
堂	táng
討厭	tǎoyàn
套	tào 
特地	tèdì 
特色	tèsè 
特殊	tèshū 
提	tí
提到	tídào 
提高	tígāo 
提供	tígōng 
題材	tícái 
題目	tímù 
體會	tĭhuì 
體力	tĭlì 
體貼	tĭtiē 
體重	tĭzhòng 
替	tì 
天堂	tiāntáng 
天天	tiāntiān
天下	tiānxià 
田	tián 
填	tián 
甜點	tiándiăn 
條件	tiáojiàn 
挑戰	tiăozhàn 
貼	tiē 
鐵	tiě 
鐵路	tiělù 
聽見	tīngjiàn 
聽力	tīnglì 
聽起來	tīngqĭlái 
聽眾	tīngzhòng 
挺	tĭng 
通	tōng 
通過	tōngguò 
通知	tōngzhī
同	tóng 
同	tóng 
同情	tóngqíng  
同時	tóngshí 
同樣	tóngyàng 
同樣	tóngyàng 
痛苦	tòngkǔ 
投	tóu 
投資	tóuzī  
頭	tóu 
頭痛	tóutòng  
圖	tú 
突然	túrán  
土	tǔ 
土地	tǔdì 
兔子	tùzi 
團體	tuántǐ 
團圓	tuányuán 
推	tuī
推薦	tuījiàn 
推銷	tuīxiāo 
退步	tuìbù 
退休	tuìxiū 
脫	tuō 
娃娃(ㄨㄚ˙)	wáwa 
外邊	wàibiān 
外公	wàigōng 
外婆	wàipó 
外文	wàiwén 
外語	wàiyǔ 
完成	wánchéng 
完全	wánquán 
玩具	wánjù 
晚	wǎn 
萬一	wànyī 
網	wăng 
網路	wănglù 
往往	wăngwăng  
忘記	wàngjì 
維持	wéichí 
微笑	wéixiào 
為主	wéizhŭ 
偉大	wěidà 
為	wèi 
未來	wèilái 
位置	wèizhì 
位子	wèizi 
溫柔	wēnróu 
文件	wénjiàn 
文學	wénxué 
文字	wénzì 
聞	wén 
穩定	wěndìng 
問好	wènhăo 
問候	wènhòu 
握手	wòshǒu 
屋子	wūzi 
無	wú 
無法	wúfă 
無論如何	wúlùnrúhé 
無窮	wúqióng 
無所謂	wúsuŏwèi 
誤會	wùhuì 
物價	wùjià 
西北	xīběi 
西餐	xīcān 
西方	xīfāng 
西南	xīnán 
吸毒	xīdú 
吸收	xīshōu 
吸引	xīyĭn 
犧牲	xīshēng 
希望	xīwàng 
喜愛	xĭài 
細	xì 
細心	xìxīn  
戲	xì 
戲劇	xìjù 
系統	xìtŏng  
下	xià 
下	xià 
下	xià 
下	xià 
下來(ㄌㄞ˙)	xiàlai
嚇	xià 
嚇一跳	xiàyítiào  
線	xiàn 
現代	xiàndài 
現代	xiàndài 
現實	xiànshí 
現實	xiànshí 
現象	xiànxiàng 
限制	xiànzhì 
相當	xiāngdāng 
相對	xiāngduì 
相反	xiāngfăn 
相關	xiāngguān 
相同	xiāngtóng 
箱子	xiāngzi
香水	xiāngshuĭ
詳細	xiángxì 
響	xiǎng 
想到	xiăngdào 
想法	xiǎngfǎ 
想像	xiăngxiàng 
想像	xiăngxiàng 
項	xiàng 
相機	xiàngjī 
相聲	xiàngshēng 
小吃	xiăochī 
小朋友	xiǎopéngyǒu 
小組	xiăozŭ 
效果	xiàoguŏ
笑話	xiàohuà
孝順	xiàoshùn 
協助	xiézhù 
血	xiě 
謝	xiè 
心得	xīndé 
心理	xīnlĭ 
心意	xīnyì 
欣賞	xīnshăng 
新生	xīnshēng 
信	xìn 
信箱	xìnxiāng 
信心	xìnxīn 
興奮	xīngfèn 
行	xíng
行動	xíngdòng 
行為	xíngwéi 
形容	xíngróng 
醒	xĭng 
醒來	xĭnglái 
姓	xìng 
性別	xìngbié 
性格	xìnggé 
幸好	xìnghăo 
幸虧	xìngkuī 
幸運	xìngyùn 
兇	xiōng 
兄弟	xiōngdì 
熊貓	xióngmāo 
修	xiū 
修改	xiūgăi 
修理	xiūlĭ  
需求	xūqiú  
需要	xūyào 
選	xuǎn 
選舉	xuănjŭ 
選擇	xuǎnzé 
選擇	xuǎnzé 
學會	xuéhuì 
學問	xuéwèn 
尋找	xúnzhăo 
訓練	xùnliàn 
呀	yā 
鴨(子)	yā(zi) 
押金	yājīn 
牙	yá 
牙齒	yáchǐ 
煙火	yānhuŏ 
研究	yánjiù 
研究	yánjiù 
嚴重	yánzhòng 
演	yăn 
演出	yănchū 
演講	yănjiăng 
演員	yănyuán 
眼光	yănguāng 
眼淚	yănlèi 
陽光	yángguāng 
養	yăng 
樣	yàng 
樣樣	yàngyàng 
邀請	yāoqĭng 
要求	yāoqiú 
要求	yāoqiú 
咬	yăo 
要	yào 
要不然	yàobùrán 
要不是	yàobúshì 
要緊	yàojǐn 
野餐	yěcān 
也好	yěhăo 
頁	yè 
夜裡/裏	yèlǐ/lǐ 
夜市	yèshì 
一下子/一下子兒	yīxiàzi/yīxiàzir
衣櫃	yīguì 
依靠	yīkào 
一塊/一塊兒	yíkuài/yíkuàir
一切	yíqiè
一向	yíxiàng 
一樣	yíyàng 
已	yĭ 
以	yĭ 
以後	yĭhòu
以來	yĭlái 
以免	yĭmiăn 
以內	yĭnèi 
以前	yĭqián
以上	yĭshàng 
以外	yĭwài 
以為	yǐwéi 
以下	yĭxià 
一般來說	yìbānláishuō 
一點/一點兒	yìdiǎn/yìdiǎnr
一方面	yìfāngmiàn 
一連	yìlián 
一生	yìshēng 
一時	yìshí 
一同	yìtóng 
意見	yìjiàn 
意外	yìwài 
意義	yìyì 
陰	yīn 
因此	yīncǐ 
音響	yīnxiăng 
引起	yĭnqĭ
應	yīng 
應該	yīnggāi 
英俊	yīngjùn 
營養	yíngyăng 
影片	yĭngpiàn 
擁有	yŏngyŏu 
用	yòng
用法	yòngfă 
用功	yònggōng 
用品	yòngpĭn 
優點	yōudiăn 
優秀	yōuxiù 
幽默	yōumò 
郵票	yóupiào
尤其	yóuqí 
遊客	yóukè 
游泳池	yóuyŏngchí
由於	yóuyú 
有(一)點/有(一)點兒	yǒu(yì)diăn/yǒu(yì)diănr
有的	yǒude 
有名	yǒumíng 
有錢	yǒuqián 
有效	yŏuxiào 
有意思	yǒuyìsi
友誼	yŏuyí 
於是	yúshì 
與	yǔ 
與	yǔ 
玉	yù 
玉米	yùmǐ 
預備	yùbèi 
預習	yùxí 
遇到	yùdào 
圓	yuán 
員工	yuángōng 
原諒	yuánliàng 
原因	yuányīn 
願望	yuànwàng 
院子	yuànzi
約	yuē 
約會	yuēhuì 
約會	yuēhuì 
越	yuè 
月餅	yuèbĭng  
閱讀	yuèdú 
樂團	yuètuán 
運氣	yùnqì 
在	zài 
在意	zàiyì 
在於	zàiyú 
早	zăo 
早日	zăorì 
早晚	zăowăn 
造成	zàochéng 
噪音	zàoyīn 
責任	zérèn 
增加	zēngjiā 
炸/炸	zhà/zhá 
摘	zhāi 
站	zhàn
暫時	zhànshí 
戰爭	zhànzhēng 
長	zhǎng
長大	zhǎngdà 
掌握	zhăngwò 
障礙	zhàngài 
招待	zhāodài 
招牌	zhāopái 
找錢	zhǎoqián 
照	zhào 
照	zhào 
哲學	zhéxué 
這裏	zhèlĭ
這下子	zhèxiàzi 
這樣	zhèyàng
這樣子	zhèyàngzi 
這樣子	zhèyàngzi 
真的	zhēnde 
真理	zhēnlĭ
真實	zhēnshí 
真是	zhēnshì 
真心	zhēnxīn 
真正	zhēnzhèng 
真正	zhēnzhèng 
珍貴	zhēnguì 
整	zhěng 
整理	zhěnglĭ 
整齊	zhěngqí 
正	zhèng 
正常	zhèngcháng 
正確	zhèngquè 
正式	zhèngshì 
證明	zhèngmíng 
證書	zhèngshū 
支	zhī 
知	zhī 
知識	zhīshì 
之後	zhīhòu 
之間	zhījiān 
之前	zhīqián
直	zhí 
直到	zhídào 
值得	zhídé 
殖民地	zhímíndì 
植物	zhíwù 
職員	zhíyuán 
指	zhǐ 
只是	zhĭshì 
只要	zhǐyào 
只有	zhǐyǒu 
只有	zhĭyŏu 
制度	zhìdù 
智慧	zhìhuì 
至少	zhìshăo 
至於	zhìyú 
中	zhōng 
中部	zhōngbù 
中餐	zhōngcān 
終於	zhōngyú 
鐘	zhōng 
種	zhòng
重點	zhòngdiăn 
重視	zhòngshì 
周圍	zhōuwéi 
主動	zhŭdòng 
主婦	zhŭfù 
主管	zhŭguăn 
主人	zhǔrén 
主任	zhǔrèn 
主題	zhŭtí 
主要	zhǔyào 
主要	zhŭyào 
主意	zhǔyì 
祝	zhù
祝福	zhùfú 
祝福	zhùfú 
助	zhù 
助理	zhùlĭ 
著名	zhùmíng 
抓	zhuā 
專心	zhuānxīn 
專業	zhuānyè 
狀態	zhuàngtài 
追求	zhuīqiú 
準時	zhŭnshí 
著	zhuó 
資料	zīliào 
資源	zīyuán 
仔細	zĭxì 
自從	zìcóng 
自動	zìdòng 
自然	zìrán 
自殺	zìshā 
自信	zìxìn 
自由	zìyóu 
自由	zìyóu 
自在	zìzài 
宗教	zōngjiào 
總而言之	zǒngéryánzhī 
總算	zǒngsuàn 
總統	zǒngtǒng 
總之	zǒngzhī 
走走	zǒuzǒu 
組	zŭ 
祖父	zŭfù 
祖母	zŭmŭ 
祖先	zŭxiān 
嘴	zuǐ 
醉	zuì 
最初	zuìchū 
最多	zuìduō 
最好	zuìhǎo 
最後	zuìhòu 
最佳	zuìjiā 
最近	zuìjìn
尊敬	zūnjìng 
作	zuò 
作品	zuòpĭn 
作者	zuòzhě 
座	zuò 
做/作法	zuòfă 
做夢	zuòmèng 
做人	zuòrén 
做事	zuòshì 
哎呀	āiya 
哎喲	āiyāo 
愛好	àihào 
愛好	àihào 
愛護	àihù 
愛人	àirén 
安慰	ānwèi 
安裝	ānzhuāng 
按	àn 
按時	ànshí 
暗	àn 
暗中	ànzhōng 
骯髒	āngzhāng 
熬	áo 
拔	bá 
把	bă 
把握	băwò 
罷工	bàgōng 
罷了	bàle 
擺脫	băituō 
敗	bài 
拜	bài 
拜拜	bàibài 
拜訪	bàifăng 
拜年	bàinián 
拜託	bàituō 
般	bān 
班	bān 
班長	bānzhăng 
搬運	bānyùn 
拌	bàn 
半路	bànlù 
半數	bànshù 
辦公	bàngōng 
辦事	bànshì 
扮演	bànyăn 
傍晚	bāngwăn 
磅	bàng 
棒	bàng 
棒子	bàngzi 
包裹	bāoguǒ
包括	bāokuò 
包裝	bāozhuāng 
包裝	bāozhuāng 
保	băo 
保持	băochí
保存	băocún
保留	băoliú 
保衛	băowèi 
保障	băozhàng 
保障	băozhàng 
寶寶	băobao
抱	bào 
報	bào 
報仇	bàochóu
報答	bàodá
報導	bàodăo
報到	bàodào
報警	bàojĭng 
報社	bàoshè 
暴力	bàolì 
暴躁	bàozào 
爆炸	bàozhà 
悲劇	bēijù 
悲痛	bēitòng 
倍	bèi 
備	bèi 
背面	bèimiàn 
奔	bēn 
奔跑	bēnpăo 
本來	běnlái 
本領	běnlĭng
本身	běnshēn 
本土	běntŭ 
笨重	bènzhòng 
比	bĭ
比方	bĭfāng 
比方(說)	bĭfāng(shūo)
比較	bǐjiào 
比較	bĭjiào 
比例	bĭlì 
彼此	bĭcĭ 
筆	bĭ
筆記	bĭjì 
筆試	bĭshì 
筆試	bĭshì 
閉	bì 
必須	bìxū 
必要	bìyào 
編	biān 
扁	biăn 
便	biàn 
便利	biànlì 
變動	biàndòng 
變動	biàndòng 
標題	biāotí 
標誌	biāozhì 
表格	biăogé 
表情	biăoqíng 
表揚	biăoyáng 
冰	bīng 
丙	bĭng 
並	bìng 
並	bìng 
並且	bìngqiě 
病毒	bìngdú 
病房	bìngfáng 
撥	bō 
菠菜	bōcài 
波動	bōdòng 
玻璃	bōlí 
薄	bó 
薄弱	bóruò 
伯父	bófù 
伯母	bómŭ 
不大	búdà 
不當	búdàng 
不到	búdào 
不顧	búgù 
不過	búguò 
不見得	bújiàndé 
捕	bŭ 
補	bŭ 
補償	bŭcháng 
補充	bŭchōng 
補課	bŭkè 
補習	bŭxí 
補助	bŭzhù 
補助	bŭzhù 
步	bù 
不安	bùān 
不成	bùchéng 
不得已	bùdéyĭ
不敢當	bùgăndāng 
不僅	bùjĭn 
不良	bùliáng
不平	bùpíng 
不然	bùrán 
不如	bùrú 
不許	bùxŭ 
不宜	bùyí 
不由得	bùyóude 
不止	bùzhǐ 
部隊	bùduì 
部長	bùzhăng 
布/佈告	bùgào
布/佈告欄	bùgàolán 
財產	cáichăn 
財富	cáifù 
才能	cáinéng 
裁判	cáipàn 
裁員	cáiyuán 
踩	căi 
採	căi 
採購	căigòu 
彩色	căisè 
參與	cānyù 
蠶	cán 
慚愧	cánkuì 
慘	căn 
倉庫	cāngkù 
藏	cáng 
操心	cāoxīn 
操作	cāozuò 
冊	cè 
策略	cèlüè 
測量	cèliáng 
測試	cèshì 
測驗	cèyàn 
測驗	cèyàn 
差	chā
差錯	chācuò 
差距	chājù 
插	chā 
插花	chāhuā 
插圖	chātú 
茶館/茶館兒	cháguăn/cháguănr
茶會	cháhuì 
茶葉	cháyè 
拆	chāi 
產	chăn 
產量	chănliàng 
產業	chănyè 
嘗/嚐	cháng
嘗/嚐試	chángshì 
常識	chángshì 
長處	chángchù 
長度	chángdù 
長方形	chángfāngxíng 
長久	chángjiŭ 
長途	chángtú 
場	chăng 
場地	chăngdì 
場合	chănghé 
場所	chăngsuŏ 
廠商	chăngshāng 
抄	chāo 
鈔票	chāopiào 
超出	chāochū 
超人	chāorén 
超越	chāoyuè 
超重	chāozhòng 
朝	cháo 
潮流	cháoliú 
潮溼/濕	cháoshī 
吵鬧	chăonào 
車票	chēpiào 
扯	chě
徹底	chèdǐ 
沉	chén 
陳列	chénliè 
稱	chēng 
撐	chēng 
成	chéng 
成	chéng 
成本	chéngběn 
成分/份	chéngfèn 
成交	chéngjiāo 
成立	chénglì 
成天	chéngtiān 
成為	chéngwéi 
成語	chéngyŭ 
乘	chéng 
乘客	chéngkè 
誠懇	chéngkěn 
誠意	chéngyì 
呈現	chéngxiàn 
程序	chéngxù 
吃虧	chīkuī 
遲	chí 
遲早	chízăo 
尺寸	chĭcùn 
翅膀	chìbăng 
沖	chōng 
充分/份	chōngfèn 
充滿	chōngmăn 
充足	chōngzú 
重	chóng 
崇拜	chóngbài 
崇高	chónggāo 
抽屜	chōutì 
愁	chóu 
出	chū 
出產	chūchăn  
出境	chūjìng 
出口	chūkŏu 
出色	chūsè 
出身	chūshēn 
出事	chūshì 
出售	chūshòu 
出席	chūxí 
出院	chūyuàn 
初	chū 
初步	chūbù 
初步	chūbù 
初級	chūjí 
除	chú 
除	chú 
除	chú 
除非	chúfēi 
儲存	chúcún 
儲蓄	chúxù 
處	chŭ 
處罰	chŭfá 
處	chù 
處處	chùchù 
傳	chuán 
傳播	chuánbò 
傳達	chuándá 
傳單	chuándān 
傳染	chuánrăn 
傳說	chuánshuō 
傳說	chuánshuō 
傳送	chuánsòng 
傳統	chuántŏng 
傳真	chuánzhēn 
窗口	chuāngkŏu 
床	chuáng 
床單	chuángdān 
幢	chuáng 
闖	chuăng 
創作	chuàngzuò 
春季	chūnjì 
春假	chūnjià 
純	chún 
磁帶	cídài 
詞典	cídiăn 
詞彙	cíhuì 
辭職	cízhí 
此外	cĭwài 
刺	cì 
刺激	cìjī 
次數	cìshù 
從	cóng 
從此	cóngcĭ
從沒	cóngméi 
從事	cóngshì 
湊	còu 
粗	cū 
粗心	cūxīn 
促進	cùjìn 
催	cuī 
存款	cúnkuăn 
搓	cuō 
錯過	cuòguò 
錯字	cuòzì 
措施	cuòshī 
答	dá 
答案	dáàn 
達到	dádào 
打	dă 
打扮	dăbàn 
打包	dăbāo 
打斷	dăduàn 
打擾	dărăo 
打算	dăsuàn 
打招呼	dăzhāohū 
打針	dăzhēn 
打字	dăzì 
大半	dàbàn 
大便	dàbiàn 
大膽	dàdăn 
大地	dàdì 
大都	dàdōu 
大哥	dàgē 
大哥大	dàgēdà 
大街	dàjiē 
大力	dàlì 
大量	dàliàng 
大腦	dànăo 
大清早	dàqīngzăo 
大嫂	dàsăo 
大腿	dàtuĭ 
大型	dàxíng 
大意	dàyì 
大有	dàyŏu 
大致	dàzhì 
大眾	dàzhòng 
大自然	dàzìrán 
待會/待會兒	dāihuĭ/dāihuĭr
待	dài
代	dài 
代	dài 
代表	dàibiăo 
代溝	dàigōu 
代價	dàijià 
代理	dàilĭ 
帶動	dàidòng 
帶路	dàilù 
帶子	dàizi 
大夫	dàifū 
貸款	dàikuăn 
貸款	dàikuăn 
待遇	dàiyù 
單	dān 
單調	dāndiào 
單位	dānwèi 
單子	dānzi 
擔保	dānbăo 
耽誤	dānwù 
膽量	dănliàng 
膽小	dănxiăo
蛋白質	dànbáizhí 
誕生	dànshēng 
當初	dāngchū 
當時	dāngshí 
當選	dāngxuăn 
當中	dāngzhōng 
擋	dăng 
檔案	dăngàn 
當	dàng 
倒楣	dăoméi 
導演	dăoyăn 
導遊	dăoyóu 
倒	dào 
道	dào 
道路	dàolù 
到達	dàodá 
得分	défēn 
得獎	déjiăng 
得了	déle 
得罪	dézuì 
登	dēng 
登記	dēngjì 
登山	dēngshān 
等不及	děngbùjí 
等到	děngdào 
等級	děngjí 
等於	děngyú 
凳子	dèngzi 
滴	dī 
低潮	dīcháo
的確	díquè 
抵	dĭ
抵抗	dĭkàng 
遞	dì 
地面	dìmiàn 
地毯	dìtăn 
地下	dìxià 
地震	dìzhèn 
典禮	diănlĭ 
典型	diănxíng 
點燃	diănrán 
點頭	diăntóu 
墊	diàn 
電報	diànbào 
電動	diàndòng 
電扇	diànshàn 
電視台	diànshìtái 
電台	diàntái 
電線	diànxiàn 
電子	diànzĭ
雕刻	diāokè  
雕刻	diāokè  
吊	diào 
釣	diào 
跌	dié 
跌倒	diédăo 
丁	dīng 
盯	dīng 
頂	dǐng 
訂婚	dìnghūn 
訂位	dìngwèi 
定期	dìngqí 
定期	dìngqí 
丟臉	diūliăn 
丟人	diūrén 
冬季	dōngjì 
懂得	dǒngde 
洞	dòng 
凍	dòng 
棟	dòng 
動不動	dòngbúdòng 
動詞	dòngcí 
動人	dòngrén 
動身	dòngshēn 
動手	dòngshǒu 
動作	dòngzuò 
鬥爭	dòuzhēng 
毒	dú 
毒	dú 
獨立	dúlì 
獨自	dúzì 
賭	dŭ 
度	dù 
度過	dùguò 
端	duān 
斷	duàn 
鍛鍊	duànliàn 
堆	duī 
隊	duì 
隊員	duìyuán 
對岸	duìàn 
對策	duìcè 
對待	duìdài 
對付	duìfù 
對抗	duìkàng 
對立	duìlì 
對於	duìyú 
蹲	dūn 
頓	dùn 
噸	dùn 
多半/多半兒	duōbàn/duōbànr
多多	duōduō 
多少	duōshăo 
多數	duōshù 
多謝	duōxiè 
奪	duó 
躲	duŏ
鵝	é
惡劣	èliè
而已	éryĭ
發	fā 
發	fā 
發動	fādòng 
發抖	fādŏu 
發起	fāqĭ 
發射	fāshè 
發行	fāxíng 
發言	fāyán 
發揚	fāyáng 
發音	fāyīn 
發展	fāzhăn 
罰	fá 
法子	fázi 
法院	făyuàn 
髮型	făxíng 
番	fān 
翻	fān 
煩	fán 
煩惱	fánnăo 
繁忙	fánmáng 
繁榮	fánróng 
繁殖	fánzhí 
反	făn 
反	făn 
反對	fănduì 
反覆	fănfù 
反抗	fănkàng 
反面	fănmiàn 
反問	fănwèn 
反映	fănyìng 
反應	fănyìng 
反正	fănzhèng 
返回	fănhuí 
犯錯	fàncuò 
犯法	fànfă 
犯人	fànrén 
犯罪	fànzuì 
方	fāng 
方案	fāngàn 
防	fáng 
防守	fángshǒu 
防止	fángzhĭ 
放大	fàngdà 
放棄	fàngqì 
放手	fàngshŏu 
放學	fàngxué 
非法	fēifă 
肥	féi 
肥胖	féipàng 
肥皂	féizào 
肺	fèi 
費	fèi 
廢話	fèihuà 
廢氣	fèiqì 
廢水	fèishuǐ 
廢物	fèiwù 
分別	fēnbié 
分別	fēnbié 
分別	fēnbié 
分布/佈	fēnbù 
分工	fēngōng 
分明	fēnmíng 
分配	fēnpèi 
分散	fēnsàn 
分手	fēnshǒu 
分數	fēnshù 
分析	fēnxī 
分析	fēnxī 
紛紛	fēnfēn 
吩咐	fēnfù 
粉筆	fěnbĭ 
份/份兒	fèn/fènr
奮鬥	fèndòu 
憤怒	fènnù 
封	fēng 
封建	fēngjiàn 
蜂蜜	fēngmì 
風氣	fēngqì 
風趣	fēngqù 
風險	fēngxiăn 
瘋	fēng 
瘋狂	fēngkuáng 
瘋子	fēngzi 
逢	féng 
縫	féng 
諷刺	fèngcì 
否定	fŏudìng 
否認	fŏurèn 
夫妻	fūqī 
夫人	fūrén 
幅	fú
扶	fú 
服	fú 
服	fú 
浮	fú 
符號	fúhào 
付	fù 
赴	fù 
副	fù 
輔導	fŭdăo 
富	fù 
富裕	fùyù 
附加	fùjiā 
婦女	fùnǚ 
複雜	fùzá 
複製	fùzhì 
該	gāi 
改革	găigé 
改造	găizào 
改正	găizhèng 
蓋(子)	gài(zi)
肝	gān 
乾杯	gānbēi 
乾脆	gāncuì 
趕	găn 
趕緊	gănjĭn 
感到	găndào 
感恩	gănēn 
感激	gănjī 
感情	gănqíng 
感染	gănrăn 
感受	gănshòu 
感受	gănshòu 
幹	gàn 
幹部	gànbù 
幹嘛	gànmá
幹嘛	gànmá
幹什麼	gànshénme 
鋼	gāng 
鋼筆	gāngbĭ
剛好	gānghăo 
港幣	găngbì 
港口	găngkŏu 
高潮	gāocháo 
高大	gāodà 
高度	gāodù 
高度	gāodù 
高峰	gāofēng 
高貴	gāoguì 
高級	gāojí 
高明	gāomíng 
高手	gāoshŏu 
高原	gāoyuán 
告	gào 
告辭	gàocí 
割	gē 
擱	gē 
歌劇	gējù 
隔	gé 
革命	gémìng 
各	gè 
各行各業	gèhánggèyè 
個別	gèbié  
個性	gèxìng 
個子/個兒	gèzi/gèr
根本	gēnběn 
根本	gēnběn 
根據	gēnjù 
供	gōng 
工程	gōngchéng 
工夫	gōngfu 
工會	gōnghuì 
工錢	gōngqián 
工資	gōngzī 
公布/佈	gōngbù 
公公	gōnggōng
公開	gōngkāi 
公立	gōnglì 
公平	gōngpíng 
公式	gōngshì 
公用	gōngyòng 
公元	gōngyuán 
供應	gōngyìng 
共	gòng 
共同	gòngtóng 
構成	gòuchéng 
構造	gòuzào 
孤單	gūdān 
估計	gūjì 
姑姑	gūgu
姑丈	gūzhàng
古典	gŭdiăn 
鼓	gŭ 
鼓勵	gŭlì 
鼓勵	gŭlì 
鼓舞	gŭwŭ 
鼓掌	gŭzhăng 
骨頭	gŭtou 
固定	gùdìng 
顧問	gùwèn 
故鄉	gùxiāng 
瓜	guā 
瓜子	guāzi 
掛號信	guàhàoxìn 
怪	guài 
官方	guānfāng 
官員	guānyuán 
關	guān 
關鍵	guānjiàn 
關上	guānshàng 
關於	guānyú 
觀光	guānguāng 
管道	guăndào 
管制	guănzhì 
慣	guàn 
慣例	guànlì 
冠軍	guànjūn 
罐頭	guàntou 
罐子	guànzi 
光	guāng 
光	guāng 
光亮	guāngliàng 
光臨	guānglín 
光明	guāngmíng 
光榮	guāngróng 
光是	guāngshì 
光線	guāngxiàn 
廣	guăng 
廣大	guăngdà 
廣泛	guăngfàn 
廣告	guănggào 
廣闊	guăngkuò 
規定	guīdìng 
規定	guīdìng 
規畫/劃	guīhuà 
規畫/劃	guīhuà 
規律	guīlǜ 
規則	guīzé 
跪	guì 
櫃臺/台	guìtái 
貴族	guìzú 
滾	gŭn 
鍋(子)	guō(zi)
國會	guóhuì 
國籍	guójí 
國際	guójì 
國立	guólì 
國旗	guóqí 
國小	guóxiăo 
國中	guózhōng 
裹	guŏ
果然	guŏrán 
過	guò 
過程	guòchéng 
過度	guòdù 
過渡	guòdù 
過節	guòjié 
過濾	guòlǜ
過期	guòqí 
過世	guòshì 
還不如	háibùrú 
還有	háiyŏu  
海關	hăiguān  
海軍	hăijūn  
海外	hăiwài  
海峽	hăixiá  
海鮮	hăixiān  
害處	hàichù 
含	hán 
含	hán 
含量	hánliàng  
寒冷	hánlěng  
喊	hăn 
汗	hàn 
行業	hángyè 
毫無	háowú 
好	hăo 
好	hăo 
好在	hăozài 
耗	hào 
好客	hàokè 
好奇	hàoqí 
號召	hàozhào 
合	hé 
合	hé 
合不來	hébùlái 
合成	héchéng 
合得來	hédelái 
合法	héfă 
合格	hégé 
合乎	héhū 
合理	hélĭ 
合適	héshì 
合算	hésuàn 
和好	héhăo 
和平	hépíng 
和氣	héqì 
何必	hébì 
何況	hékuàng 
河流	héliú 
嘿	hēi 
黑暗	hēiàn 
黑夜	hēiyè 
痕跡	hénjī 
恨	hèn 
橫	héng 
喉嚨	hóulóng 
猴子	hóuzi 
後代	hòudài 
後方	hòufāng 
後果	hòuguŏ
後悔	hòuhuĭ 
後年	hòunián 
後頭	hòutou 
後退	hòutuì 
後院	hòuyuàn 
呼	hū 
呼吸	hūxī 
忽略	hūlüè 
忽視	hūshì 
蝴蝶	húdié 
鬍子	húzi 
戶	hù 
戶外	hùwài 
互助	hùzhù 
花草	huācăo 
花費	huāfèi 
花費	huāfèi 
花盆	huāpén 
花瓶	huāpíng 
花色	huāsè 
花生	huāshēng 
划	huá 
滑	huá 
滑	huá 
華僑	huáqiáo 
華人	huárén 
化	huà 
化	huà 
化學	huàxué 
化妝	huàzhuāng 
化裝	huàzhuāng 
懷念	huáiniàn 
懷孕	huáiyùn 
壞蛋	huàidàn 
歡呼	huānhū 
歡樂	huānlè 
歡喜	huānxĭ 
緩和	huănhé 
緩慢	huănmàn 
幻想	huànxiăng 
幻想	huànxiăng 
慌	huāng 
皇帝	huángdì 
黃豆	huángdòu 
黃昏	huánghūn 
灰	huī 
灰色	huīsè 
灰心	huīxīn 
揮	huī 
回	huí 
回電	huídiàn 
回教/伊斯蘭教	huíjiào /yīsīlánjiào
回收	huíshōu 
回頭	huítóu 
回信	huíxìn 
回憶	huíyì 
匯款	huìkuăn 
會員	huìyuán 
昏倒	hūndăo 
昏迷	hūnmí 
混	hùn 
混合	hùnhé 
活該	huógāi 
活力	huólì 
活潑	huópō 
活躍	huóyuè 
火柴	huŏchái 
火腿	huŏtuĭ 
火災	huŏzāi 
禍	huò 
或多或少	huòduōhuòshăo 
或者	huòzhě 
貨物	huòwù 
獲得	huòdé 
肌肉	jīròu  
基本上	jīběnshàng  
基金	jījīn  
幾乎	jīhū  
機構	jīgòu  
機關	jīguān  
機票	jīpiào  
機械	jīxiè  
及格	jígé  
及時	jíshí 
即將	jíjiāng  
即使	jíshĭ 
極	jí
極其	jíqí  
級	jí 
集	jí 
集	jí 
集合	jíhé 
集郵	jíyóu  
集中	jízhōng  
集中	jízhōng  
疾病	jíbìng 
急忙	jímáng  
寂寞	jímò  
既然	jìrán  
技術	jìshù  
計算	jìsuàn  
計較	jìjiào  
記性	jìxìng 
記憶	jìyì 
記載	jìzài 
記住	jìzhù 
加班	jiābān 
加工	jiāgōng 
加上	jiāshàng 
加速	jiāsù 
加以	jiāyǐ 
家事	jiāshì 
夾	jiá 
甲	jiă 
嫁	jià 
駕駛	jiàshĭ 
駕駛	jiàshĭ 
價值	jiàzhí 
尖	jiān 
尖銳	jiānruì 
肩	jiān 
兼	jiān 
間	jiān 
堅定	jiāndìng 
堅決	jiānjué 
監視	jiānshì 
監獄	jiānyù 
揀	jiăn 
撿	jiăn 
剪刀	jiăndāo 
檢驗	jiănyàn 
建	jiàn 
建國	jiànguó 
建築	jiànzhú 
建築	jiànzhú 
箭	jiàn 
漸漸	jiànjiàn 
間接	jiànjiē 
鍵盤	jiànpán 
健全	jiànquán 
江	jiāng 
將	jiāng 
將要	jiāngyào 
獎金	jiăngjīn 
獎品	jiăngpĭn 
降	jiàng 
降價	jiàngjià 
澆	jiāo 
交代	jiāodài 
交換	jiāohuàn 
交際	jiāojì 
交往	jiāowăng 
交易	jiāoyì 
交易	jiāoyì 
郊外	jiāowài 
角	jiăo 
角落	jiăoluò 
繳	jiăo 
腳步	jiăobù 
較	jiào 
叫喊	jiàohăn 
教會	jiàohuì 
教授	jiàoshòu 
教學	jiàoxué 
教訓	jiàoxùn 
接	jiē 
接待	jiēdài 
接到	jiēdào 
接見	jiējiàn 
接近	jiējìn 
接近	jiējìn 
街道	jiēdào 
街頭	jiētóu 
階段	jiēduàn 
節	jié 
節省	jiéshěng 
節約	jiéyuē 
結	jié 
結構	jiégòu 
結果	jiéguŏ 
結果	jiéguŏ 
結合	jiéhé 
結論	jiélùn 
結算	jiésuàn 
結帳	jiézhàng 
截止	jiézhĭ 
解	jiě 
解除	jiěchú 
解答	jiědá 
屆	jiè 
界線	jièxiàn 
戒指	jièzhĭ 
今後	jīnhòu  
金額	jīné 
金融	jīnróng 
金屬	jīnshŭ 
儘管	jĭnguăn 
儘量	jĭnliàng  
緊急	jĭnjí 
僅僅	jĭnjĭn
近	jìn
近來	jìnlái  
近視	jìnshì  
盡力	jìnlì 
進入	jìnrù  
進口	jìnkŏu  
禁止	jìnzhĭ  
浸	jìn 
精彩	jīngcăi  
精力	jīnglì 
精細	jīngxì 
經濟	jīngjì  
經歷	jīnglì 
經歷	jīnglì  
經營	jīngyíng 
京劇	jīngjù 
驚人	jīngrén  
警告	jǐnggào  
警告	jǐnggào  
景色	jĭngsè 
靜	jìng 
鏡(子)	jìng(zi)
敬愛	jìngài 
敬酒	jìngjiŭ 
敬禮	jìnglĭ
淨化	jìnghuà 
竟然	jìngrán 
競爭	jìngzhēng 
糾正	jiūzhèng 
酒會	jiŭhuì 
就	jiù 
就是	jiùshì 
就是說	jiùshìshuō 
就業	jiùyè 
救火	jiùhuŏ 
究竟	jiùjìng 
居民	jūmín 
居然	jūrán 
局	jú 
鞠躬	júgōng 
巨大	jùdà 
具	jù 
具	jù 
具備	jùbèi 
具體	jùtĭ
俱樂部	jùlèbù 
聚集	jùjí 
距離	jùlí 
劇場	jùchăng 
劇烈	jùliè 
劇院	jùyuàn 
據說	jùshuō 
捐	juān 
捐款	juānkuăn 
捐款	juānkuăn 
卷	juăn 
捲	juăn 
決/絕	jué
決心	juéxīn 
決心	juéxīn 
絕不	juébù 
絕大部分	juédàbùfèn 
絕對	juéduì 
覺悟	juéwù 
軍	jūn 
軍事	jūnshì 
卡	kă 
卡	kă 
卡通	kătōng 
開	kāi 
開除	kāichú 
開刀	kāidāo 
開發	kāifā 
開戶	kāihù 
開課	kāikè 
開明	kāimíng 
開設	kāishè 
開拓	kāituò 
開演	kāiyăn 
看家	kānjiā 
砍	kăn 
看	kàn 
看得起	kàndeqĭ
看看(ㄎㄢ˙)	kànkan
看來	kànlái 
看樣子	kànyàngzi 
抗議	kàngyì 
考察	kăochá 
考卷	kăojuàn 
考慮	kăolǜ
考取	kăoqŭ 
靠	kào
靠近	kàojìn 
科	kē
科目	kēmù 
顆	kē 
可是	kěshì 
可喜	kěxĭ
可笑	kěxiào 
客房	kèfáng 
客觀	kèguān 
客戶	kèhù 
課外	kèwài 
空	kōng 
空前	kōngqián 
空中	kōngzhōng 
恐怖	kŏngbù
空/空兒	kòng/kòngr
控制	kòngzhì  
口	kŏu
口才	kŏucái
口號	kŏuhào
口紅	kŏuhóng
口氣	kŏuqì  
口試	kŏushì  
口試	kŏushì  
口水	kŏushuĭ 
口音	kŏuyīn  
口語	kŏuyŭ  
扣	kòu 
誇獎	kuājiăng 
跨	kuà
會計	kuàijì 
寬度	kuāndù 
喇叭(ㄅㄚ˙)	lăba 
蠟燭	làzhú  
辣椒	làjiāo 
來	lái 
來回	láihuí  
來臨	láilín  
來往	láiwăng  
來信	láixìn  
來源	láiyuán  
來自	láizì  
籃子	lánzi 
懶	lăn 
懶得	lănde 
爛	làn 
濫用	lànyòng 
狼	láng 
浪	làng 
浪費	làngfèi 
撈	lāo 
牢	láo 
牢騷	láosāo 
勞動	láodòng 
勞工	láogōng 
勞力	láolì 
嘮叨(ㄉㄠ˙)	láodao 
老	lăo 
老百姓	lăobăixìng 
老闆娘/老板娘	lăobănniáng
老大	lăodà 
老家	lăojiā 
老實說	lăoshíshuō 
老太太	lăotàitai 
樂意	lèyì 
類似	lèisì 
冷靜	lěngjìng 
冷飲	lěngyĭn 
梨(子)	lí(zi)
理	lĭ
理	lĭ
理由	lĭyóu
裡/裏頭	lĭtou
禮	lĭ
禮品	lĭpĭn
力氣	lìqì 
立	lì 
立場	lìchăng 
立即	lìjí 
利	lì 
利潤	lìrùn 
利息	lìxí 
例外	lìwài 
粒	lì 
聯合	liánhé 
聯合國	liánhéguó 
連	lián 
連接	liánjiē 
連忙	liánmáng 
連續	liánxù 
臉色	liănsè 
量	liáng 
糧食	liángshí 
倆	liăng 
亮	liàng 
諒解	liàngjiě 
了	liăo 
列	liè 
裂	liè 
淋	lín 
臨	lín 
臨時	línshí 
凌晨	língchén 
靈活	línghuó 
零件	língjiàn 
零售	língshòu 
零下	língxià 
領帶	lĭngdài
領導	lĭngdăo 
領土	lĭngtŭ 
領先	lĭngxiān 
領袖	lĭngxiù 
另	lìng 
另外	lìngwài 
另外	lìngwài 
溜	liū 
流動	liúdòng 
流利	liúlì 
留念	liúniàn 
嘍	lóu 
摟	lǒu 
露	lù 
路燈	lùdēng  
路線	lùxiàn  
陸軍	lùjūn  
陸續	lùxù  
錄用	lùyòng  
輪船	lúnchuán 
輪流	lúnliú 
輪子	lúnzi 
論	lùn 
論文	lùnwén 
落	luò 
落後	luòhòu  
落實	luòshí  
落伍	luòwŭ  
旅行社	lǚxíngshè 
綠豆	lǜdòu 
略	lüè 
麻	má 
麻雀	máquè 
馬虎(ㄏㄨ˙)	măhu
埋	mái 
買單	măidān 
買賣	 măimài  
饅頭	mántou 
滿/蠻	măn/mán
漫畫	mànhuà 
忙碌	mánglù 
盲目	mángmù 
矛盾	máodùn 
毛巾	máojīn 
冒	mào 
煤	méi 
梅花	méihuā 
美觀	měiguān 
美妙	měimiào 
魅力	mèilì 
門	 mén 
門票	ménpiào 
門診	ménzhěn 
猛	 měng  
夢到	mèngdào 
夢想	mèngxiăng 
夢想	 mèngxiăng  
迷	mí 
迷糊	míhú 
迷失	míshī 
迷信	míxìn 
迷信	míxìn 
密	mì 
蜜蜂	mìfēng 
秘/祕書	mìshū 
棉	mián 
棉被	miánbèi 
棉花	miánhuā 
免得	miănde 
勉強	 miǎnqiǎng 
面	miàn
面對	miànduì 
面臨	miànlín 
面貌	miànmào 
面子	miànzi 
麵粉	miànfěn 
妙	miào 
滅亡	mièwáng 
民間	mínjiān 
民謠	 mínyáo  
民眾	 mínzhòng  
民主	mínzhŭ 
民主	mínzhŭ 
名	míng 
名	míng 
名稱	míngchēng 
名單	míngdān 
名牌	míngpái 
名片	míngpiàn 
明白	míngbái 
明亮	míngliàng 
明明	míngmíng 
明確	míngquè 
命	mìng 
命令	mìnglìng 
命令	mìnglìng 
命運	mìngyùn 
磨	mó 
模仿	mófăng 
模糊	móhú 
模型	móxíng 
模樣	móyàng 
抹	mŏ
目標	mùbiāo 
目的地	mùdìdì 
目錄	mùlù 
哪怕	năpà 
奶粉	năifěn 
耐心	nàixīn 
耐用	nàiyòng 
難道	nándào 
難得	nándé 
難受	nánshòu 
難以	nányǐ 
男性	nánxìng
腦袋	năodài 
腦筋	năojīn 
鬧	nào 
鬧區	nàoqū 
內部	nèibù 
內地	nèidì
內行	nèiháng 
內科	nèikē 
能幹	nénggàn 
能源	néngyuán 
泥	ní 
泥土	nítŭ 
粘	nián 
黏	nián 
黏	nián 
尿	niào 
尿	niào 
捏	niē 
寧可	níngkě 
寧願	níngyuàn 
鈕扣	niŭkòu 
農場	nóngchăng 
農產品	nóngchănpĭn  
農村	nóngcūn  
農民/農夫	nóngmín/nóngfū 
農藥	nóngyào  
濃	nóng 
濃厚	nónghòu  
暖	nuăn
暖和	nuănhuo 
暖氣	nuănqì  
女性	nǚxìng 
偶然	ǒurán 
排	pái 
排	pái 
排斥	páichì  
排列	páiliè 
排球	páiqiú  
派	pài 
攀	pān 
盤	pán
判斷	pànduàn 
泡	pào 
炮	pào 
砲	pào 
賠	péi 
賠償	péicháng 
陪同	péitóng  
佩服	pèifú 
噴	pēn 
盆	pén 
膨脹	péngzhàng 
捧	pěng 
碰見	pèngjiàn 
匹	pī 
批	pī 
批	pī 
批判	pīpàn 
皮	pí 
披	pī 
疲倦	píjuàn 
疲勞	píláo 
脾氣	píqì 
屁股(ㄍㄨ˙)	pìgu 
篇	piān 
偏/偏偏	piān/piānpiān
偏食	piānshí 
偏向	piānxiàng 
騙	piàn 
片面	piànmiàn 
片子	piànzi 
飄	piāo 
拼命	pīnmìng 
貧窮	pínqióng 
品德	pĭndé 
聘請	pìnqĭng 
憑	píng 
平常	píngcháng 
平衡	pínghéng 
平靜	píngjìng 
平均	píngjūn 
婆婆	pópó 
頗	pŏ
破爛	pòlàn 
破裂	pòliè 
迫切	pòqiè 
撲	pū 
撲滅	pūmiè 
鋪	pū 
普及	pŭjí 
普通	pŭtōng 
普通話	pŭtōnghuà 
瀑布	pùbù 
欺騙	qīpiàn 
妻子	qīzĭ 
期	qí
期	qí
期限	qíxiàn 
其	qí 
其餘	qíyú 
棋	qí 
齊	qí 
齊全	qíquán 
旗袍	qípáo 
旗子	qízi 
歧視	qíshì 
起	qĭ
起	qĭ
起初	qĭchū 
起火	qĭhuŏ
企圖	qìtú 
企圖	qìtú 
汽油	qìyóu 
器材	qìcái 
器官	qìguān 
氣氛	qìfēn 
氣憤	qìfèn 
氣候	qìhòu 
氣味	qìwèi 
氣息	qìxí 
氣象	qìxiàng 
千萬	qiānwàn 
牽	qiān 
遷	qiān 
簽	qiān 
簽訂	qiāndìng 
簽約	qiānyuē 
簽字	qiānzì 
前方	qiánfāng 
前進	qiánjìn 
前頭	qiántou 
前途	qiántú 
前往	qiánwăng 
前院	qiányuàn 
欠	qiàn 
歉意	qiànyì 
槍	qiāng 
強	qiáng 
強大	qiángdà 
強度	qiángdù 
強烈	qiángliè 
強迫	qiángpò 
強人	qiángrén 
牆壁	qiángbì 
搶救	qiăngjiù 
敲	qiāo 
瞧	qiáo 
巧	qiăo
巧妙	qiăomiào 
悄悄	qiăoqiăo
切	qiē 
且	qiě 
親愛	qīnài 
親口	qīnkŏu 
親戚	qīnqī  
親人	qīnrén 
侵害	qīnhài 
侵入	qīnrù 
勤勞	qínláo 
寢室	qǐnshì 
青	qīng 
清	qīng 
清晨	qīngchén 
清除	qīngchú 
清楚	qīngchŭ 
清淡	qīngdàn 
清晰	qīngxī  
清醒	qīngxĭng  
輕傷	qīngshāng  
輕視	qīngshì 
傾向	qīngxiàng 
情書	qíngshū  
情緒	qíngxù 
秋季	qiūjì 
求婚	qiúhūn 
球隊	qiúduì 
球鞋	qiúxié 
曲折	qūzhé 
區別	qūbié 
區別	qūbié 
區域	qūyù 
取	qŭ 
取得	qŭdé 
取笑	qŭxiào 
取消	qŭxiāo 
娶	qŭ 
去	qù 
圈	quān 
全家	quánjiā 
全面	quánmiàn 
全面	quánmiàn 
全體	quántĭ
拳頭	quántou
權利	quánlì 
勸	quàn 
缺	quē 
缺乏	quēfá 
缺少	quēshăo 
缺席	quēxí 
確實	quèshí 
群	qún 
群眾	qúnzhòng 
然而	ránér 
燃料	ránliào 
燃燒	ránshāo 
染	răn 
讓	ràng 
讓步	ràngbù 
繞	rào 
惹	rě 
惹	rě 
熱愛	rèài 
熱烈	rèliè 
熱門	rèmén 
熱情	rèqíng 
熱情	rèqíng 
熱心	rèxīn 
人才	réncái 
人格	réngé 
人工	réngōng 
人力	rénlì 
人情味/人情味兒	rénqíngwèi/rénqíngwèir
人權	rénquán 
人生	rénshēng 
人事	rénshì 
人體	réntǐ 
人心	rénxīn 
人行道	rénxíngdào 
人員	rényuán 
忍不住	rěnbúzhù 
忍受	rěnshòu 
忍心	rěnxīn 
任	rèn 
任性	rènxìng 
日常	rìcháng 
日後	rìhòu 
日用品	rìyòngpĭn 
容	róng 
融化	rónghuà 
榮幸	róngxìng 
如	rú 
如果說	rúguŏshuō
如何	rúhé 
如何	rúhé 
如今	rújīn 
如同	rútóng 
入	rù 
入境	rùjìng
入口	rùkŏu
入學	rùxué 
軟	ruăn 
塞	sāi
賽跑	sàipăo 
三角形	sānjiăoxíng 
散	sàn
散	sàn
喪失	sàngshī 
艘	sāo 
掃	săo 
色彩	sècăi 
色情	sèqíng 
沙	shā 
沙漠	shāmò  
沙灘	shātān  
沙子	shāzi  
殺價	shājià 
傻	shă 
曬太陽	shàitàiyáng 
山地	shāndì 
閃	shăn 
閃	shăn 
善於	shànyú 
扇子	shànzi 
傷	shāng 
傷	shāng 
傷腦筋	shāngnăojīn 
商標	shāngbiāo 
商場	shāngchăng 
商量	shāngliáng 
上	shàng 
上級	shàngjí 
上升	shàngshēng 
上市	shàngshì 
上述	shàngshù 
上台/臺	shàngtái 
上頭	shàngtou 
上下	shàngxià 
上游	shàngyóu 
稍	shāo 
稍微	shāowéi 
少數	shăoshù 
少年	shàonián 
少女	shàonǚ 
舌頭	shétou 
捨不得	shěbùdé 
捨得	shědé 
射	shè 
社會	shèhuì 
社交	shèjiāo 
社團	shètuán 
設立	shèlì 
設置	shèzhì 
攝影	shèyĭng 
申請	shēnqĭng 
伸	shēn 
伸手	shēnshŏu
身材	shēncái 
身分/份	shēnfèn 
身分/份證	shēnfènzhèng 
深刻	shēnkè 
深淺	shēnqiăn 
深夜	shēnyè 
神	shén 
神話	shénhuà 
神經	shénjīng 
神秘	shénmì 
神奇	shénqí 
神氣	shénqì 
神聖	shénshèng 
神仙	shénxiān 
審查	shěnchá 
慎重	shènzhòng 
升	shēng 
升高	shēnggāo 
升級	shēngjí 
升學	shēngxué 
生	shēng 
生存	shēngcún 
生肖	shēngxiào 
生長	shēngzhăng 
聲	shēng
繩(子)	shéng(zi)
省	shěng 
省得	shěngde 
勝	shèng 
勝利	shènglì 
失敗	shībài 
失掉	shīdiào 
失眠	shīmián 
失望	shīwàng 
失業	shīyè 
溼	shī 
詩	shī 
詩人	shīrén 
師父(ㄈㄨ˙)	shīfu
師傅	shīfù 
師母	shīmŭ 
施工	shīgōng 
時常	shícháng 
時機	shíjī 
時期	shíqí 
時時	shíshí 
食品	shípǐn 
實用	shíyòng 
實在	shízài 
實施	shíshī 
實現	shíxiàn 
實驗	shíyàn 
實驗	shíyàn 
使	shĭ
始終	shĭzhōng 
示威	shìwēi 
式樣	shìyàng 
世	shì 
世紀	shìjì 
市立	shìlì 
市民	shìmín 
市區	shìqū 
視	shì 
視野	shìyě 
適當	shìdàng 
適合	shìhé 
適用	shìyòng 
是非	shìfēi 
是否	shìfŏu 
事件	shìjiàn 
事實上	shìshíshàng 
事物	shìwù 
事先	shìxiān 
勢力	shìlì 
試驗	shìyàn 
收據	shōujù 
收看	shōukàn 
收入	shōurù 
收拾	shōushí 
手電筒	shŏudiàntŏng  
手段	shŏuduàn  
手工	shŏugōng  
手術	shŏushù  
首	shŏu 
首都	shŏudū  
首先	shŏuxiān  
受	shòu 
受	shòu 
受不了	shòubùliăo  
受到	shòudào  
售	shòu 
壽命	shòumìng  
疏忽	shūhū 
書房	shūfáng 
書籍	shūjí 
輸出	shūchū
輸入	shūrù 
熟	shú 
熟練	shúliàn 
熟人	shúrén 
屬	shŭ 
屬於	shŭyú 
暑期	shŭqí 
束	shù 
數	shù 
數量	shùliàng 
數目	shùmù 
樹林	shùlín 
刷	shuā 
刷(子)	shuā(zi)
刷卡	shuākă 
耍	shuă 
摔	shuāi 
衰退	shuāituì 
甩	shuăi 
率領	shuàilĭng 
雙	shuāng 
雙胞胎	shuāngbāotāi 
雙方	shuāngfāng 
水分/份	shuĭfèn 
水災	shuǐzāi 
稅	shuì 
說服	shuìfú 
順	shùn 
順	shùn 
順手	shùnshŏu 
順序	shùnxù 
說不定	shuōbúdìng 
碩士	shuòshì 
絲	sī 
撕	sī 
私立	sīlì 
私人	sīrén 
思索	sīsuŏ 
死	sĭ
死亡	sĭwáng 
四處	sìchù 
四處	sìchù 
四方	sìfāng 
四季	sìjì 
四周/週	sìzhōu 
飼養	sìyăng 
鬆	sōng 
送行	sòngxíng 
俗	sú 
俗話	súhuà  
俗話說	súhuàshuō 
算	suàn 
算起來	suànqĭlái  
算是	suànshì  
算帳	suànzhàng  
隨	suí 
隨手	suíshŏu
隨意	suíyì  
隨著	suízhe 
碎	suì 
歲數	suìshù  
孫女	sūnnǚ 
孫子	sūnzi 
損失	sŭnshī 
損失	sŭnshī 
縮	suō 
縮短	suōduăn 
縮水	suōshuĭ
鎖	suŏ 
鎖	suŏ 
塌	tā 
踏	tà 
抬頭	táitóu 
太空	tàikōng 
攤子	tānzi 
彈	tán 
談判	tánpàn 
毯子	tănzi 
探	tàn 
探親	tànqīn 
探討	tàntăo 
趟	tàng 
燙	tàng 
燙	tàng 
掏	tāo 
逃	táo 
逃避	táobì 
逃走	táozŏu 
陶瓷	táocí 
淘氣	táoqì 
桃子	táozi 
討	tăo 
套	tào
套	tào 
特別	tèbié 
特點	tèdiăn 
提	tí 
提起	tíqĭ
提前	tíqián 
提醒	tíxĭng 
提早	tízăo 
題	tí 
體溫	tĭwēn 
體驗	tǐyàn 
天才	tiāncái 
天空	tiānkōng 
天然	tiānrán 
天文	tiānwén 
天真	tiānzhēn 
天主教	Tiānzhŭjiào
田野	tiányě 
挑	tiāo 
挑選	tiāoxuăn 
條	tiáo 
條約	tiáoyuē 
調	tiáo 
調整	tiáozhěng 
跳高	tiàogāo 
跳遠	tiàoyuăn 
貼心	tiēxīn 
停止	tíngzhĭ 
挺	tĭng 
挺	tĭng 
通	tōng
通	tōng 
通常	tōngcháng  
通過	tōngguò 
通信	tōngxìn  
通訊	tōngxùn  
同	tóng 
同	tóng 
同胞	tóngbāo  
同志	tóngzhì  
銅	tóng 
桶	tǒng 
統計	tǒngjì  
統一	tǒngyī  
統治	tǒngzhì  
痛快	tòngkuài 
偷/偷偷	tōu/tōutōu
頭	tóu
頭腦	tóunăo 
投票	tóupiào 
投入	tóurù  
投降	tóuxiáng  
投資	tóuzī  
透	tòu 
透過	tòuguò 
禿	tū 
突出	túchū 
突破	túpò  
突破	túpò  
途徑	tújìng 
圖書	túshū  
圖章	túzhāng  
吐	tŭ 
團	tuán 
團結	tuánjié 
推動	tuīdòng 
推翻	tuīfān 
推廣	tuīguăng 
退	tuì 
退出	tuìchū 
退回	tuìhuí 
吞	tūn 
拖	tuō 
拖鞋	tuōxié 
托兒所	tuōérsuŏ 
脫離	tuōlí 
妥當(ㄉㄤ˙)	tuǒdang
妥善	tuŏshàn 
妥協	tuŏxié 
哇	wā 
挖	wā 
歪	wāi 
外部	wàibù 
外出	wàichū 
外地	wàidì 
外觀	wàiguān 
外行	wàiháng 
外匯	wàihuì 
外交	wàijiāo 
外界	wàijiè 
外科	wàikē 
外頭	wàitou 
彎	wān 
彎腰	wānyāo 
完畢	wánbì 
完善	wánshàn 
完整	wánzhěng 
玩笑	wánxiào 
晚輩	wănbèi 
往	wăng 
望	wàng 
威脅	wēixié 
威脅	wēixié 
圍	wéi 
違反	wéifăn 
維護	wéihù 
維他命	wéitāmìng 
危機	wéijī 
為難	wéinán 
唯一	wéiyī 
尾巴	wěiba 
委屈	wěiqū 
委託	wěituō 
委員	wěiyuán 
未	wèi 
未婚	wèihūn 
位於	wèiyú 
味/味兒	wèi/wèir
味精	wèijīng 
為何	wèihé 
衛生	wèishēng 
衛生紙	wèishēngzhĭ 
衛星	wèixīng 
慰問	wèiwèn 
溫和	wēnhé 
文法	wénfă 
文具	wénjù 
文憑	wénpíng 
文物	wénwù 
文藝	wényì 
蚊子	wénzi 
吻	wěn 
吻	wěn 
穩	wěn 
握	wò 
臥房	wòfáng 
汙/污染	wūrăn
無可奈何	wúkěnàihé 
無論	wúlùn 
無情	wúqíng 
無數	wúshù 
無限	wúxiàn 
無意	wúyì 
武器	wŭqì 
武術	wŭshù 
舞	wŭ 
舞蹈	wŭdào 
舞台/臺	wŭtái 
舞廳	wŭtīng 
勿	wù 
物理	wùlǐ 
物質	wùzhí 
誤	wù 
誤	wù 
誤點	wùdiăn 
誤會	wùhuì 
霧	wù 
西裝	xīzhuāng 
吸	xī 
吸取	xīqŭ 
吸食	xīshí 
吸煙	xīyān 
媳婦	xífù 
喜酒	xĭjiŭ 
喜劇	xǐjù 
系列	xìliè  
細胞	xìbāo  
細節	xìjié  
細菌	xìjùn  
細小	xìxiăo  
瞎	xiā 
蝦(子)	xiā(zi)
蝦米	xiāmĭ 
下巴	xiàbā  
下降	xiàjiàng  
下來	xiàlái  
下棋	xiàqí  
下去	xiàqù  
下午茶	xiàwŭchá  
下游	xiàyóu  
夏季	xiàjì  
先進	xiānjìn 
鮮	xiān 
鮮花	xiānhuā 
鮮奶	xiānnăi 
鮮血	xiānxiě 
閒	xián 
嫌	xián 
顯得	xiănde 
顯然	xiănrán 
顯示	xiănshì 
顯著	xiănzhù 
現	xiàn 
現場	xiànchăng 
現成	xiànchéng 
現金	xiànjīn 
羨慕	xiànmù 
限制	xiànzhì 
相	xiāng 
相處	xiāngchŭ 
相當	xiāngdāng 
相互	xiānghù 
相親相愛	xiāngqīnxiāngài 
相似	xiāngsì 
箱	xiāng 
香腸	xiāngcháng 
鄉村	xiāngcūn 
想不到	xiăngbúdào 
想念	xiăngniàn 
享受	xiăngshòu 
享有	xiăngyŏu 
響應	xiăngyìng 
象	xiàng 
相片/相片兒	xiàngpiàn/xiàngpiànr
相親	xiàngqīn 
巷(子)	xiàng(zi)
向來	xiànglái 
項目	xiàngmù 
消	xiāo 
消除	xiāochú 
消費	xiāofèi 
消費	xiāofèi 
消化	xiāohuà 
消極	xiāojí 
消滅	xiāomiè 
消失	xiāoshī 
消/宵夜	xiāoyè 
銷路	xiāolù 
銷售	xiāoshòu 
小便	xiăobiàn 
小費	xiăofèi 
小麥	xiăomài 
小氣	xiăoqì 
小腿	xiăotuǐ 
小子	xiăozi 
曉得	xiăode 
校車	xiàochē 
校友	xiàoyŏu 
效率	xiàolǜ 
笑容	xiàoróng 
歇	xiē 
斜	xié 
血管	xiěguăn 
血型	xiěxíng 
血液	xiěyè 
心靈	xīnlíng 
心目中	xīnmùzhōng 
心聲	xīnshēng 
心跳	xīntiào 
心臟	xīnzàng 
新郎	xīnláng 
新娘	xīnniáng 
新式	xīnshì 
新興	xīnxīng 
薪水	xīnshuĭ 
信號	xìnhào 
信任	xìnrèn 
信仰	xìnyăng 
信仰	xìnyăng 
信用	xìnyòng 
星光	xīngguāng 
行程	xíngchéng 
行動	xíngdòng 
行人	xíngrén 
形成	xíngchéng 
形式	xíngshì 
形象	xíngxiàng 
形狀	xíngzhuàng 
性質	xìngzhí 
雄偉	xióngwěi 
休假	xiūjià 
休閒	xiūxián  
修正	xiūzhèng  
需	xū 
須知	xūzhī  
許	xŭ 
許願	xŭyuàn  
宣布/佈	xuānbù
宣傳	xuānchuán 
宣傳	xuānchuán 
懸	xuán 
選手	xuănshŏu 
靴(子)	xuē(zi)
學會	xuéhuì 
學歷	xuélì 
學術	xuéshù 
學位	xuéwèi 
學業	xuéyè 
學者	xuézhě 
雪花	xuěhuā 
削減	xuèjiăn 
尋	xún 
循環	xúnhuán 
迅速	xùnsù 
壓	yā 
壓力	yālì 
壓迫	yāpò 
牙膏	yágāo 
煙/菸	yān
沿	yán 
嚴	yán 
嚴格	yángé 
嚴肅	yánsù 
鹽巴	yánbā 
延長	yáncháng 
癌症	yánzhèng 
演唱	yănchàng 
演奏	yănzòu 
掩蓋	yăngài 
宴會	yànhuì 
厭惡	yànwù 
癢	yăng 
氧氣	yăngqì 
樣品	yàngpĭn 
喲	yāo 
腰	yāo 
搖	yáo 
搖擺	yáobăi 
搖頭	yáotóu 
要不	yàobù 
要好	yàohăo 
要命	yàomìng 
藥方	yàofāng 
藥水	yàoshuĭ 
藥物	yàowù 
野	yě 
野獸	yěshòu 
野心	yěxīn 
夜景	yèjǐng 
夜晚	yèwăn 
業務	yèwù 
業餘	yèyú 
葉子	yèzi 
一一	yīyī 
衣裳	yīshang 
依據	yījù 
依然	yīrán 
醫	yī 
醫師	yīshī 
醫學	yīxué 
一帶	yídài 
一旦	yídàn 
一大早	yídàzăo 
一面	yímiàn 
一再	yízài 
一致	yízhì 
移	yí 
移動	yídòng 
移民	yímín 
疑問	yíwèn 
儀器	yíqì 
儀式	yíshì 
乙	yĭ
已婚	yĭhūn
以	yĭ
以便	yĭbiàn 
以及	yĭjí 
以往	yĭwăng 
一般而言	yìbānéryán 
一口氣	yìkŏuqì 
一旁	yìpáng 
一齊	yìqí 
一天到晚	yìtiāndàowăn 
易	yì 
意識	yìshì 
意外	yìwài 
意願	yìyuàn
意志	yìzhì 
億	yì 
義務	yìwù 
議會	yìhuì 
因而	yīnér 
因素	yīnsù 
銀	yín 
引發	yĭnfā 
飲	yĭn 
飲食	yĭnshí 
印	yìn 
印刷	yìnshuā 
印象	yìnxiàng 
印章	yìnzhāng 
應當	yīngdāng 
嬰兒	yīngér 
英雄	yīngxióng 
贏得	yíngdé 
迎接	yíngjiē 
營養	yíngyăng 
營業	yíngyè 
影本	yĭngběn 
影印	yĭngyìn 
影子	yĭngzi 
硬	yìng 
應付	yìngfù 
應邀	yìngyāo 
應用	yìngyòng 
擁抱	yŏngbào 
擁護	yŏnghù 
擁擠	yŏngjĭ 
勇氣	yŏngqì 
用不著	yòngbùzháo
用處	yòngchù 
用得著	yòngdezháo
用具	yòngjù 
用力	yònglì 
用心	yòngxīn 
憂鬱	yōuyù 
優惠	yōuhuì 
優良	yōuliáng 
優美	yōuměi 
優越	yōuyuè 
由	yóu 
油	yóu 
油膩	yóunì 
游	yóu 
郵差	yóuchāi 
郵件	yóujiàn 
遊戲	yóuxì 
遊戲	yóuxì 
遊行	yóuxíng 
猶豫	yóuyù 
友好	yŏuhăo 
有關	yŏuguān 
有關	yŏuguān 
有力	yŏulì 
有利	yŏulì 
有些	yŏuxiē 
有些	yŏuxiē 
娛樂	yúlè 
語調	yŭdiào 
語氣	yŭqì 
語音	yŭyīn 
與其	yŭqí 
遇	yù 
遇見	yùjiàn 
預報	yùbào 
預定	yùdìng 
預訂	yùdìng 
預計	yùjì 
預算	yùsuàn 
預先	yùxiān 
冤枉	yuānwăng 
元旦	yuándàn 
原來	yuánlái 
原理	yuánlĭ 
原料	yuánliào 
原始	yuánshĭ 
原先	yuánxiān 
原則	yuánzé 
原則上	yuánzéshàng 
原子筆	yuánzĭbĭ 
圓滿	yuánmăn 
圓形	yuánxíng 
緣故	yuángù 
遠大	yuăndà 
願	yuàn 
月份	yuèfèn 
月光	yuèguāng 
月球	yuèqiú 
暈	yūn 
允許	yŭnxŭ 
運輸	yùnshū 
運送	yùnsòng 
運用	yùnyòng 
運轉	yùnzhuăn 
砸	zá 
雜	zá 
災害	zāihài 
災難	zāinàn 
在	zài
在乎	zàihū 
再度	zàidù 
再說	zàishuō 
載	zài 
咱們	zánmen 
贊成	zànchéng 
贊同	zàntóng 
讚美	zànměi 
葬禮	zànglĭ
糟	zāo 
糟糕	zāogāo 
遭到	zāodào 
遭受	zāoshòu 
遭遇	zāoyù 
早晨	zăochén 
早點	zăodiăn 
早點	zăodiăn 
早晚	zǎowǎn 
早已	zăoyĭ 
造	zào 
造句	zàojù 
則	zé 
則	zé 
怎	zěn 
增長	zēngzhăng 
贈品	zèngpĭn 
贈送	zèngsòng 
窄	zhăi 
展出	zhănchū 
展開	zhănkāi 
展覽	zhănlăn 
展覽	zhănlăn 
展示	zhănshì 
占/佔	zhàn 
占/佔	zhàn 
占/佔有	zhànyŏu 
站住	zhànzhù 
戰場	zhànchăng 
張	zhāng 
章	zhāng 
長	zhǎng 
長輩	zhǎngbèi
漲	zhăng 
漲價	zhăngjià 
掌聲	zhăngshēng 
帳單	zhàngdān 
丈夫	zhàngfū 
招呼	zhāohū 
招手	zhāoshŏu 
照	zhào 
照常	zhàocháng 
召開	zhàokāi 
折	zhé 
折合	zhéhé 
折扣	zhékòu 
折磨	zhémó 
者	zhě 
針	zhēn 
針對	zhēnduì 
偵探	zhēntàn 
珍惜	zhēnxí 
珍珠	zhēnzhū 
真心	zhēnxīn 
枕頭	zhěntou 
陣	zhèn 
陣子	zhènzi 
震動	zhèndòng 
爭	zhēng 
爭論	zhēnglùn 
爭取	zhēngqŭ 
睜	zhēng 
徵求	zhēngqiú 
正月	zhēngyuè 
整	zhěng 
整	zhěng 
整潔	zhěngjié 
整數	zhěngshù 
正	zhèng 
正方形	zhèngfāngxíng 
正規	zhèngguī 
正好	zhènghăo 
正好	zhènghăo 
正經	zhèngjīng 
正面	zhèngmiàn 
政策	zhèngcè 
政黨	zhèngdăng 
政府	zhèngfŭ 
證件	zhèngjiàn 
證據	zhèngjù 
證明	zhèngmíng 
證實	zhèngshí 
症狀	zhèngzhuàng 
之	zhī 
之	zhī 
之後	zhīhòu 
之間	zhījiān 
之類	zhīlèi 
之前	zhīqián 
支	zhī
支持	zhīchí 
支出	zhīchū 
支票	zhīpiào 
支援	zhīyuán 
直	zhí 
直接	zhíjiē 
直線	zhíxiàn 
值	zhí 
擲	zhí 
職位	zhíwèi 
執行	zhíxíng 
止	zhǐ 
只	zhĭ
只是	zhĭshì 
指	zhĭ 
指出	zhĭchū 
指導	zhĭdăo 
指定	zhĭdìng 
指示	zhĭshì 
指示	zhĭshì 
指責	zhǐzé 
紙張	zhĭzhāng 
治	zhì 
至	zhì 
制定	zhìdìng 
制止	zhìzhĭ
志氣	zhìqì 
志願	zhìyuàn 
秩序	zhìxù 
製造	zhìzào 
製作	zhìzuò 
中	zhōng 
中級	zhōngjí 
中年	zhōngnián 
中途	zhōngtú 
中央	zhōngyāng 
中藥	zhōngyào 
腫	zhŏng 
種類	zhŏnglèi 
種子	zhŏngzĭ 
種族	zhŏngzú 
中	zhòng 
中毒	zhòngdú 
重	zhòng 
重大	zhòngdà 
重量	zhòngliàng 
重傷	zhòngshāng 
重傷	zhòngshāng 
重心	zhòngxīn 
州	zhōu 
周/週	zhōu 
周到	zhōudào 
粥	zhōu 
竹(子)	zhú(zi)
逐漸	zhújiàn 
主辦	zhŭbàn 
主持	zhŭchí 
主觀	zhŭguān 
主角/角	zhŭjiăo/jué
主席	zhŭxí 
主張	zhŭzhāng 
主張	zhŭzhāng 
祝賀	zhùhè 
住院	zhùyuàn 
住宅	zhùzhái 
住址	zhùzhĭ
注射	zhùshè 
註冊	zhùcè 
專家	zhuānjiā 
專利	zhuānlì 
專門	zhuānmén 
專人	zhuānrén 
專業	zhuānyè 
轉	zhuăn 
轉變	zhuănbiàn 
轉播	zhuănbò 
轉達	zhuăndá 
轉告	zhuăngào 
轉機	zhuănjī 
轉身	zhuănshēn 
轉向	zhuănxiàng 
轉	zhuàn 
賺	zhuàn 
裝飾	zhuāngshì 
壯	zhuàng 
撞	zhuàng 
狀況	zhuàngkuàng 
追	zhuī 
准	zhŭn 
准考證/証	zhŭnkăozhèng 
準	zhŭn 
準確	zhŭnquè 
捉	zhuō 
桌	zhuō 
資本	zīběn 
資格	zīgé 
資金	zījīn 
資訊	zīxùn 
紫	zĭ 
子女	zĭnǚ 
字幕	zìmù 
字母	zìmŭ 
自來水	zìláishuĭ
自然	zìrán 
自私	zìsī 
自我	zìwǒ 
自信	zìxìn 
自願	zìyuàn 
自主	zìzhŭ 
總	zǒng 
總共	zǒnggòng 
總理	zǒnglĭ 
綜合	zònghé 
綜合	zònghé 
走道	zǒudào 
走私	zǒusī 
足	zú
足以	zúyĭ 
組	zŭ 
組織	zŭzhī 
阻礙	zŭài 
阻止	zŭzhĭ
祖國	zŭguó 
鑽	zuān 
鑽石	zuànshí
罪	zuì 
最少	zuìshăo 
遵守	zūnshŏu 
尊重	zūnzhòng 
左右	zuŏyòu 
左右	zuŏyòu 
作	zuò 
作家	zuòjiā 
作為	zuòwéi 
作文	zuòwén 
作文	zuòwén 
作用	zuòyòng 
做	zuò 
做客	zuòkè 
挨	āi 
欸	ăi
愛戴	àidài 
愛國	àiguó 
愛滋病	àizībìng 
安頓	āndùn 
安撫	ānfŭ 
安寧	ānníng 
安詳	ānxiáng 
安置	ānzhì 
暗暗	ànàn 
案件	ànjiàn 
案情	ànqíng 
案子	ànzi 
按摩	ànmó 
昂貴	ángguì 
奧妙	àomiào 
懊惱	àonăo 
八卦	bāguà 
八字	bāzì 
把	bă
把持	băchí 
把手	băshǒu 
白皮書	báipíshū 
拜會	bàihuì 
頒發	bānfā 
頒獎	bānjiăng 
辦案	bànàn 
半島	bàndăo 
半導體	bàndăotǐ 
幫	bāng 
綁	băng 
包袱	bāofú 
包圍	bāowéi 
寶	băo 
寶貝	băobèi 
寶石	băoshí 
飽和	băohé 
飽滿	băomăn 
保安	băoān 
保管	băoguăn 
保齡球	băolíngqiú 
保姆	băomŭ 
保全	băoquán 
保險	băoxiăn 
保佑	băoyòu 
保重	băozhòng 
報案	bàoàn 
報表	bàobiăo 
報酬	bàochóu 
報導	bàodǎo
報復	bàofù 
報關	bàoguān 
報價	bàojià 
報刊	bàokān 
報應	bàoyìng 
報章	bàozhāng
暴力	bàolì 
暴雨	bàoyŭ 
爆發	bàofā 
抱負	bàofù 
抱歉	bàoqiàn
碑	bēi 
悲哀	bēiāi 
悲觀	bēiguān 
貝殼	bèiké 
倍數	bèishù 
背誦	bèisòng 
背心	bèixīn 
被子	bèizi 
奔騰	bēnténg 
本	běn 
本事	běnshì 
本位	běnwèi 
本性	běnxìng 
本質	běnzhí
崩潰	bēngkuì 
甭	béng 
敝	bì
必	bì 
編輯	biānjí 
編輯	biānjí 
編寫	biānxiě 
編織	biānzhī 
編制	biānzhì 
編製	biānzhì 
邊界	biānjiè 
邊緣	biānyuán 
貶	biăn 
貶值	biănzhí 
匾額	biăné 
便	biàn 
辨認	biànrèn 
辨識	biànshì 
辯	biàn 
辯護	biànhù 
辯論	biànlùn 
變革	biàngé 
變遷	biànqiān 
變通	biàntōng 
變形	biànxíng 
標籤	biāoqiān 
標語	biāoyŭ 
表白	biăobái 
表明	biăomíng 
鼻孔	bíkǒng 
鼻涕	bítì 
筆錄	bǐlù 
筆友	bǐyǒu
比率	bǐlǜ 
比擬	bǐnǐ 
比喻	bǐyù
比重	bǐzhòng 
必備	bìbèi 
必定	bìdìng 
必然	bìrán 
閉幕	bìmù 
閉塞	bìsè 
避難	bìnàn
避孕	bìyùn 
畢生	bìshēng 
幣值	bìzhí 
憋	biē 
別	bié 
別墅	biéshù 
兵	bīng 
賓館	bīnguăn 
柄	bǐng 
並列	bìngliè 
並重	bìngzhòng 
併發	bìngfā 
病床	bìngchuáng 
病菌	bìngjùn 
病情	bìngqíng 
撥	bō 
波	bō 
波及	bōjí  
波浪	bōlàng 
剝	bō 
剝削	bōxuè 
搏鬥	bódòu 
播出	bòchū 
不便	búbiàn 
不動產	búdòngchăn 
不力	búlì 
不料	búliào 
不下	búxià 
不肖	búxiào 
不懈	búxiè 
不再	búzài 
不致	búzhì 
不至/致於	búzhìyú 
補給	bǔjǐ
補救	bŭjiù 
補習班	bǔxíbān
哺乳動物	bŭrŭdòngwù 
不得	bùdé
不等	bùděng
不凡	bùfán 
不妨	bùfáng 
不法	bùfă 
不公	bùgōng 
不禁	bùjīn
不及	bùjí 
不堪	bùkān
不免	bùmiăn 
不容	bùróng 
不時	bùshí 
不惜	bùxí 
不知不覺	bùzhībùjué
部落	bùluò 
部署	bùshŭ 
步調	bùdiào 
步驟	bùzòu
猜測	cāicè 
猜忌	cāijì 
猜想	cāixiăng 
裁縫	cáiféng 
裁減	cáijiăn 
財團	cáituán 
財政	cáizhèng 
才智	cáizhì 
採訪	căifăng 
採光	căiguāng 
採納	căinà 
採取	căiqŭ 
彩繪	căihuì 
餐具	cānjù 
參謀	cānmóu 
殘暴	cánbào 
殘酷	cánkù 
殘殺	cánshā 
慘重	cănzhòng 
燦爛	cànlàn 
蒼白	cāngbái 
蒼蠅	cāngyíng 
操縱	cāozòng 
草案	căoàn 
草叢	căocóng 
草率	căoshuài 
草藥	căoyào 
測	cè 
策畫/劃	cèhuà 
差額	chāé 
插曲	chāqŭ 
插嘴	chāzuǐ 
茶具	chájù 
察覺	chájué 
查明	chámíng 
蟬	chán
饞	chán 
潺潺	chánchán 
猖獗	chāngjué 
腸	cháng 
長遠	chángyuăn 
場次	chăngcì 
場面	chăngmiàn 
倡導	chàngdăo 
唱腔	chàngqiāng 
暢銷	chàngxiāo 
產物	chănwù 
產值	chănzhí 
超速	chāosù 
超脫	chāotuō 
抄襲	chāoxí 
吵嘴	chăozuǐ 
車輛	chēliàng 
車廂	chēxiāng 
撤回	chèhuí 
撤銷	chèxiāo 
沉默	chénmò 
沉思	chénsī 
沉重	chénzhòng 
塵土	chéntŭ 
呈	chéng 
乘	chéng 
承包	chéngbāo 
承擔	chéngdān
承諾	chéngnuò 
成敗	chéngbài 
成見	chéngjiàn 
成就	chéngjiù 
成品	chéngpǐn 
成全	chéngquán 
成人	chéngrén
成效	chéngxiào 
成衣	chéngyī 
成員	chéngyuán 
成長	chéngzhǎng
稱號	chēnghào 
稱呼	chēnghū 
撐腰	chēngyāo 
程式	chéngshì 
呈獻	chéngxiàn 
誠心	chéngxīn 
誠心誠意	chéngxīnchéngyì  
誠摯	chéngzhì 
稱	chèng 
吃驚	chījīng 
吃苦	chīkŭ 
吃力	chīlì 
持	chí 
持久	chíjiŭ 
持平	chípíng 
持續	chíxù 
池(子)	chí(zi)
遲鈍	chídùn 
充斥	chōngchì 
充裕	chōngyù 
沖淡	chōngdàn 
沖天	chōngtiān 
衝	chōng 
衝動	chōngdòng 
衝擊	chōngjí 
衝突	chōngtú 
憧憬	chōngjǐng 
重疊	chóngdié 
崇尚	chóngshàng 
寵愛	chǒngài 
寵物	chǒngwù
抽查	chōuchá 
抽空	chōukòng  
抽象	chōuxiàng 
抽樣	chōuyàng 
愁	chóu 
仇	chóu 
仇恨	chóuhèn 
稠密	chóumì 
出超	chūchāo 
出錯	chūcuò 
出發點	chūfādiăn 
出局	chūjú 
出口	chūkǒu
出力	chūlì 
出路	chūlù 
出馬	chūmă 
出賣	chūmài 
出面	chūmiàn 
出名	chūmíng 
出品	chūpǐn 
出示	chūshì 
出手	chūshǒu 
出頭	chūtóu 
出頭	chūtóu 
出土	chūtŭ 
出息	chūxí 
出血	chūxiě 
初期	chūqí 
儲備	chúbèi 
除此之外	chúcǐzhīwài
鋤頭	chútou
處	chŭ 
處方	chŭfāng 
處分	chŭfèn 
處分	chŭfèn 
處境	chŭjìng 
處事	chŭshì 
處於	chŭyú 
處女	chùnǚ 
穿梭	chuānsuō 
傳	chuán 
傳遞	chuándì 
傳奇	chuánqí 
傳奇	chuánqí 
傳神	chuánshén 
傳授	chuánshòu 
船隻	chuánzhī 
喘	chuăn 
串	chuàn 
創傷	chuāngshāng 
創	chuàng 
創辦	chuàngbàn 
創立	chuànglì 
創新	chuàngxīn 
創業	chuàngyè 
創作	chuàngzuò 
吹牛	chuīniú 
垂	chuí 
垂直	chuízhí 
辭	cí 
辭典	cídiǎn
辭行	cíxíng 
慈善	císhàn 
此刻	cǐkè 
次	cì 
次要	cìyào 
伺候	cìhòu 
刺殺	cìshā 
匆忙	cōngmáng 
從容	cōngróng
從而	cóngér 
湊巧	còuqiăo 
粗糙	cūcāo 
粗魯	cūlŭ 
促	cù 
促成	cùchéng 
促使	cùshǐ 
促銷	cùxiāo 
簇擁	cùyǒng 
摧殘	cuīcán 
摧毀	cuīhuǐ 
催眠	cuīmián 
脆弱	cuìruò 
存貨	cúnhuò 
磋商	cuōshāng 
撮合	cuòhé 
搭配	dāpèi 
達	dá 
答覆	dáfù 
打	dă 
打鬥	dădòu 
打賭	dădŭ 
打發	dăfā 
打擊	dăjí 
打量	dăliàng 
打獵	dăliè 
打牌	dăpái 
打手	dăshǒu 
打烊	dăyáng 
大道	dàdào 
大隊	dàduì 
大使	dàshǐ 
大選	dàxuăn 
大洋洲	dàyángzhōu
大意	dàyì 
大致	dàzhì 
呆	dāi 
待	dāi 
歹徒	dăitú 
逮捕	dàibǔ
代課	dàikè 
怠慢	dàimàn 
擔	dān
擔當	dāndāng 
擔負	dānfù 
單獨	dāndú 
單價	dānjià 
單據	dānjù 
單親	dānqīn 
單行道	dānxíngdào 
膽	dăn 
膽固醇	dăngùchún 
但	dàn 
淡季	dànjì
淡水	dànshuǐ 
刀	dāo 
導師	dăoshī 
導致	dăozhì 
島嶼	dăoyŭ 
道	dào 
道別	dàobié 
道地	dàodì 
道士	dàoshì 
道義	dàoyì 
到期	dàoqí 
到頭來	dàotóulái 
倒數	dàoshǔ
當	dāng 
當兵	dāngbīng 
當代	dāngdài 
當局	dāngjú 
當前	dāngqián 
當心	dāngxīn 
黨派	dăngpài 
黨員	dăngyuán 
得以	déyǐ 
登場	dēngchăng 
登陸	dēnglù 
燈火	dēnghuǒ 
燈籠	dēnglóng 
等候	děnghòu 
等價	děngjià 
瞪	dèng 
滴	dī 
嘀咕	dígū 
底片	dǐpiàn 
抵	dǐ 
抵押	dǐyā 
抵制	dǐzhì 
地表	dìbiăo 
地步	dìbù 
地勢	dìshì 
地域	dìyù 
地獄	dìyù 
地質	dìzhí 
地主	dìzhŭ 
締結	dìjié 
締造	dìzào 
弟兄	dìxiōng 
顛覆	diānfù 
典型	diănxíng 
典雅	diănyă 
點子	diănzi 
奠定	diàndìng 
惦記	diànjì 
電工	diàngōng 
電力	diànlì 
電流	diànliú 
電器	diànqì 
電視劇	diànshìjù 
電壓	diànyā 
凋零	diāolíng 
調	diào
調查	diàochá
調度	diàodù 
吊橋	diàoqiáo
釣魚	diàoyú 
疊	dié 
頂	dǐng 
頂	dǐng 
定額	dìngé 
定義	dìngyì 
釘	dìng 
訂購	dìnggòu 
丟棄	diūqì 
凍結	dòngjié 
洞穴	dòngxuè 
動產	dòngchăn
動機	dòngjī 
動靜	dòngjìng 
動力	dònglì 
動亂	dòngluàn 
動脈	dòngmài 
動態	dòngtài 
動向	dòngxiàng 
動員	dòngyuán 
抖	dǒu 
陡	dǒu 
逗留	dòuliú 
鬥志	dòuzhì 
督促	dūcù 
獨創	dúchuàng 
獨到	dúdào 
獨占/佔	dúzhàn 
讀物	dúwù 
堵	dŭ 
堵塞	dŭsè 
賭博	dŭbó 
賭場	dŭchăng 
渡	dù 
度量衡	dùliánghéng 
端正	duānzhèng 
短缺	duănquē 
短暫	duănzhàn 
斷絕	duànjué 
堆積	duījī 
隊伍	duìwŭ 
兌現	duìxiàn 
對比	duìbǐ 
對照	duìzhào 
對峙	duìzhì 
頓	dùn 
頓	dùn 
頓時	dùnshí 
多寡	duōguă 
多虧	duōkuī 
多媒體	duōméitǐ 
多元	duōyuán 
奪魁	duókuí 
躲避	duǒbì 
墮胎	duòtāi 
額外	éwài 
惡	è 
惡化	èhuà 
惡性	èxìng 
惡意	èyì 
恩愛	ēnài 
恩情	ēnqíng 
恩人	ēnrén 
恩怨	ēnyuàn 
而	ér 
而是	érshì
而言	éryán
兒女	érnǚ 
耳光	ěrguāng 
發	fā 
發電	fādiàn 
發瘋	fāfēng 
發掘	fājué
發誓	fāshì 
發炎	fāyán 
發音	fāyīn
發育	fāyù 
發展	fāzhǎn
發作	fāzuò
法定	fădìng 
法官	făguān 
法令	fălìng 
法人	fărén 
法則	făzé 
法制	făzhì 
法治	făzhì 
翻臉	fānliăn 
翻身	fānshēn 
翻新	fānxīn 
繁多	fánduō 
繁體	fántǐ
藩籬	fánlí 
凡/凡是	fánshì
返	făn 
反擊	fănjí 
反射	fănshè 
反省	fănxǐng 
反之	fănzhī 
犯規	fànguī 
販毒	fàndú 
販賣	fànmài 
方位	fāngwèi 
方向盤	fāngxiàngpán 
方針	fāngzhēn 
方正	fāngzhèng 
妨礙	fángài 
防備	fángbèi 
防範	fángfàn 
防水	fángshuǐ 
防衛	fángwèi 
防禦	fángyù 
防治	fángzhì 
仿冒	făngmào 
仿造	făngzào 
紡織	făngzhī 
放蕩	fàngdàng 
放寬	fàngkuān 
放款	fàngkuăn 
放任	fàngrèn 
放鬆	fàngsōng 
放映	fàngyìng 
放逐	fàngzhú 
非凡	fēifán 
非洲	fēizhōu
飛彈	fēidàn 
飛快	fēikuài 
飛翔	fēixiáng 
飛行	fēixíng 
肥料	féiliào 
廢	fèi 
廢除	fèichú 
廢棄	fèiqì 
廢墟	fèixū 
廢止	fèizhǐ 
費力	fèilì 
沸騰	fèiténg 
肺炎	fèiyán 
分貝	fēnbèi 
分辨	fēnbiàn 
分寸	fēncùn 
分擔	fēndān 
分發	fēnfā 
分割	fēngē 
分化	fēnhuà 
分級	fēnjí 
分家	fēnjiā 
分解	fēnjiě 
分離	fēnlí 
分裂	fēnliè 
分泌	fēnmì 
分明	fēnmíng 
分享	fēnxiăng 
分子	fēnzǐ 
墳墓	fénmù
粉紅	fěnhóng 
粉刷	fěnshuā 
分量	fènliàng 
糞	fèn
封	fēng 
封閉	fēngbì 
封鎖	fēngsuǒ 
封條	fēngtiáo 
風暴	fēngbào 
風潮	fēngcháo 
風光	fēngguāng 
風光	fēngguāng 
風化	fēnghuà 
風力	fēnglì 
風尚	fēngshàng 
風水	fēngshuǐ 
風行	fēngxíng
鋒面	fēngmiàn 
豐盛	fēngshèng 
豐收	fēngshōu 
縫	fèng 
奉獻	fèngxiàn 
奉養	fèngyàng 
佛經	fójīng 
佛像	fóxiàng 
否決	fǒujué 
膚淺	fūqiăn 
敷衍	fūyăn 
俘虜	fúlŭ 
俘虜	fúlŭ 
浮動	fúdòng 
服從	fúcóng 
服飾	fúshì 
服務	fúwù
服刑	fúxíng 
幅度	fúdù 
福氣	fúqì 
輻射	fúshè 
斧頭	fŭtou 
撫養	fŭyăng 
撫育	fŭyù 
腐爛	fŭlàn 
腐蝕	fŭshí 
腐朽	fŭxiŭ 
付	fù
付款	fùkuăn 
負	fù 
負面	fùmiàn
副	fù 
富	fù 
富貴	fùguì 
富有	fùyǒu 
婦人	fùrén 
附上	fùshàng 
復甦	fùsū 
復原	fùyuán 
賦予	fùyŭ 
該死	gāisǐ 
改編	găibiān 
改觀	găiguān 
改良	găiliáng 
改選	găixuăn 
鈣	gài 
概	gài 
概括	gàiguā 
概況	gàikuàng 
蓋章	gàizhāng 
尷尬	gāngà
干擾	gānrăo 
干涉	gānshè 
乾燥	gānzào 
感觸	gănchù 
感性	gănxìng
趕忙	gănmáng 
綱領	gānglǐng 
剛強	gāngqiáng 
鋼鐵	gāngtiě 
崗位	găngwèi 
高見	gāojiàn 
高壓	gāoyā 
告別	gàobié 
告狀	gàozhuàng 
胳膊(ㄅㄛ˙)	gēbo
歌唱	gēchàng 
歌手	gēshǒu
歌頌	gēsòng 
疙瘩	gēda
鴿子	gēzi 
隔	gé 
隔閡	géhé 
隔天	gétiān
格局	géjú 
格式	géshì 
格外	géwài 
革新	géxīn 
各界	gèjiè 
各自	gèzì 
個數	gèshù
個體	gètǐ 
給予	gěiyŭ 
跟進	gēnjìn 
跟前	gēnqián 
根源	gēnyuán 
耕地	gēngdì 
更動	gēngdòng 
弓	gōng 
工地	gōngdì 
工讀	gōngdú 
工藝品	gōngyìpǐn 
公安	gōngān 
公費	gōngfèi 
公會	gōnghuì 
公民	gōngmín 
公認	gōngrèn 
公事	gōngshì 
公文	gōngwén 
公務	gōngwù 
公務員	gōngwùyuán 
公益	gōngyì 
公債	gōngzhài 
功勞	gōngláo 
功利	gōnglì 
攻	gōng 
攻讀	gōngdú 
攻擊	gōngjí 
供給	gōnjǐ 
宮殿	gōngdiàn 
恭敬	gōngjìng 
恭維	gōngwéi 
鞏固	gǒnggù 
共產	gòngchăn 
共和國	gònghéguó 
共鳴	gòngmíng 
供養	gòngyăng 
勾結	gōujié 
溝	gōu
購	gòu 
構想	gòuxiăng 
孤獨	gūdú 
孤兒	gūér 
孤立	gūlì 
辜負	gūfù 
估價	gūjià 
古怪	gŭguài 
古跡	gŭjī 
古籍	gŭjí 
古物	gŭwù 
股	gŭ 
股市	gŭshì 
鼓吹	gŭchuī 
鼓動	gŭdòng 
故	gù 
雇/僱	gù 
雇/僱用	gùyòng 
固然	gùrán 
固體	gùtǐ 
固有	gùyǒu 
固執	gùzhí 
顧全	gùquán 
蝸牛	guāniú 
寡婦	guăfù 
拐	guăi 
怪不得	guàibùdé 
官	guān 
官司	guānsī 
棺材	guāncái 
觀	guàn 
觀測	guāncè 
觀感	guāngăn 
觀光	guānguāng
觀看	guānkàn
觀摩	guānmó 
觀望	guānwàng 
關稅	guānshuì 
關切	guānqiè  
關懷	guānhuái 
關頭	guāntóu 
關係	guānxì
關照	guānzhào 
管教	guănjiào 
管理	guǎnlǐ
管線	guănxiàn 
管子	guănzi 
貫徹	guànchè 
慣	guàn 
灌	guàn 
灌溉	guàngài 
灌輸	guànshū 
光顧	guānggù 
光滑	guānghuá 
光輝	guānghuī 
光芒	guāngmáng 
規範	guīfàn 
規格	guīgé 
規矩	guījŭ 
規則	guīzé 
歸	guī 
歸	guī 
歸還	guīhuán 
歸納	guīnà 
軌道	guǐdào 
鬼怪	guǐguài 
貴	guì
貴賓	guìbīn 
棍子	gùnzi 
國產	guóchăn 
國防	guófáng 
國境	guójìng 
國君	guójūn 
國民	guómín
國營	guóyíng 
果斷	guǒduàn 
果實	guǒshí 
果樹	guǒshù
果真	guǒzhēn 
過關	guòguān 
過量	guòliàng 
過敏	guòmǐn 
過目	guòmù 
過人	guòrén 
過失	guòshī 
過癮	guòyǐn 
過重	guòzhòng 
海拔	hăibá 
海面	hăimiàn 
海嘯	hǎixiào
海運	hăiyùn 
害蟲	hàichóng 
喊	hăn 
行號	hánghào 
行列	hángliè 
航空信	hángkōngxìn 
航行	hángxíng 
毫不	háobù 
好比	hăobǐ 
好手	hăoshǒu 
好受	hăoshòu 
號	hào 
號子/證券行	hàozi /zhèngquànháng
合併	hébìng 
合同	hétóng 
合意	héyì 
合約	héyuē 
何	hé 
何在	hézài 
和解	héjiě 
和睦	hémù 
和諧	héxié 
核定	hédìng 
核對	héduì 
核算	hésuàn 
核准	hézhŭn 
核子	hézǐ 
黑名單	hēimíngdān 
黑社會	hēishèhuì 
狠	hěn 
狠心	hěnxīn 
哼	hēng 
哼	hēng 
橫	héng 
衡量	héngliáng
轟動	hōngdòng 
轟轟烈烈	hōnghōnglièliè 
紅利	hónglì 
紅燒	hóngshāo 
洪水	hóngshuǐ 
宏偉	hóngwěi 
哄	hǒng 
後輩	hòubèi
後天	hòutiān
候選人	hòuxuănrén 
呼籲	hūyù 
壺	hú 
胡亂	húluàn 
狐疑	húyí 
戶口	hùkǒu 
互補	hùbŭ 
互動	hùdòng
互惠	hùhuì 
護	hù 
花瓣	huābàn 
花朵	huāduǒ 
花卉	huāhuì 
花紋	huāwén 
花樣	huāyàng 
划不來	huábùlái 
划得來	huádelái 
華裔	huáyì 
化工	huàgōng 
化石	huàshí 
話劇	huàjù 
畫面	huàmiàn 
畫展	huàzhăn 
劃時代	huàshídài 
懷	huái 
懷疑	huáiyí
歡送	huānsòng 
幻象	huànxiàng 
換取	huànqŭ 
患	huàn 
患者	huànzhě 
荒唐	huāngtáng 
慌張	huāngzhāng 
惶恐	huángkǒng 
恍惚	huănghū 
灰	huī 
灰塵	huīchén 
輝煌	huīhuáng 
回合	huíhé 
回絕	huíjué 
回升	huíshēng 
回憶	huíyì
迴/回響	huíxiăng 
毀	huǐ 
毀損	huǐsŭn 
悔恨	huǐhèn 
匯	huì 
匯票	huìpiào 
會見	huìjiàn 
會談	huìtán 
會意	huìyì 
繪畫	huìhuà 
賄賂	huìlù 
彗星	huìxīng 
昏	hūn 
渾身	húnshēn 
混	hùn 
混淆	hùnyáo 
混濁	hùnzhuó 
活/活兒	huó/huór
活期	huóqí 
火箭	huǒjiàn 
火力	huǒlì 
火焰	huǒyàn 
火藥	huǒyào 
伙伴	huǒbàn 
獲	huò 
貨幣	huòbì 
貨品	huòpǐn 
豁達	huòdá 
積	jī
基層	jīcéng 
基地	jīdì 
基督	Jīdū
基因	jīyīn 
機動	jīdòng 
機警	jījǐng 
機率	jīlǜ
機密	jīmì 
機器人	jīqìrén 
機制	jīzhì 
肌膚	jīfū 
飢餓	jīè 
畸形	jīxíng
激增	jīzēng 
及早	jízăo 
吉利	jílì 
吉祥	jíxiáng 
汲取	jíqŭ 
即	jí 
即	jí 
即日	jírì 
即時	jíshí 
嫉妒	jídù 
極端	jíduān 
極端	jíduān 
極力	jílì 
極為	jíwéi
集合	jíhé  
集結	jíjié 
集權	jíquán 
集體	jítǐ 
集團	jítuán 
急救	jíjiù 
急躁	jízào 
急診	jízhěn 
籍貫	jíguàn 
擊	jí 
擊落	jíluò 
計	jì 
暨	jì 
繼承	jìchéng 
季風	jìfēng 
劑量	jìliàng 
紀律	jìlǜ
技能	jìnéng 
技藝	jìyì 
祭祀	jìsì 
傢伙(ㄏㄨㄛ˙)	jiāhuo
家家戶戶	jiājiāhùhù 
家電	jiādiàn 
家屬	jiāshŭ 
佳節	jiājié 
佳人	jiārén 
加緊	jiājǐn 
加快	jiākuài 
加薪	jiāxīn 
加重	jiāzhòng 
枷鎖	jiāsuǒ 
夾雜	jiázá 
假	jiǎ 
假若	jiăruò 
假使	jiăshǐ 
假象	jiăxiàng 
架	jià 
架(子)	jià(zi)
架構	jiàgòu 
假期	jiàqí 
煎	jiān 
監督	jiāndū 
尖端	jiānduān 
堅固	jiāngù 
堅忍	jiānrěn 
堅信	jiānxìn 
堅硬	jiānyìng 
兼職	jiānzhí 
艱鉅	jiānjù 
艱苦	jiānkŭ 
艱難	jiānnán 
簡便	jiănbiàn 
簡稱	jiănchēng 
簡化	jiănhuà 
簡體	jiăntǐ
檢討	jiăntăo 
漸	jiàn 
賤	jiàn 
濺	jiàn 
見解	jiànjiě 
見識	jiànshì 
見證	jiànzhèng 
建造	jiànzào 
健身	jiànshēn 
健身房	jiànshēnfáng 
健壯	jiànzhuàng 
將	jiāng 
將軍	jiāngjūn 
獎勵	jiănglì 
獎賞	jiăngshăng 
獎狀	jiăngzhuàng 
講理	jiănglǐ 
講習	jiăngxí 
講義	jiăngyì 
講座	jiăngzuò 
交錯	jiāocuò 
交貨	jiāohuò 
交集	jiāojí 
交情	jiāoqíng 
交涉	jiāoshè 
交談	jiāotán 
焦急	jiāojí 
腳本	jiăoběn 
攪和	jiǎohuo
轎車	jiàochē 
叫好	jiàohăo 
教官	jiàoguān 
教化	jiàohuà 
教誨	jiàohuǐ 
教徒	jiàotú 
教學	jiàoxué
教員	jiàoyuán 
較量	jiàoliàng 
皆	jiē 
階層	jiēcéng 
階級	jiējí 
街坊(ㄈㄤ˙)	jiēfang
接管	jiēguăn 
接連	jiēlián 
接納	jiēnà 
接洽	jiēqià 
接下來	jiēxiàlái
揭幕	jiēmù 
揭曉	jiēxiăo 
截	jié 
截	jié 
潔白	jiébái 
節儉	jiéjiăn 
節慶	jiéqìng 
竭力	jiélì 
結實(ㄕ˙)	jiéshi 
結業	jiéyè 
結緣	jiéyuán 
捷運	jiéyùn
解答	jiědá 
解放	jiěfàng 
解渴	jiěkě 
解剖	jiěpǒu
解說	jiěshuō 
解體	jiětǐ 
解脫	jiětuō 
解約	jiěyuē 
屆	jiè
屆時	jièshí 
戒	jiè 
戒備	jièbèi 
借貸	jièdài 
藉口	jièkǒu 
介入	jièrù 
金錢	jīnqián  
金魚	jīnyú 
津貼	jīntiē 
緊湊	jǐncòu 
緊密	jǐnmì 
緊縮	jǐnsuō 
謹慎	jǐnshèn 
近	jìn 
近	jìn
勁/勁兒	jìn/jìnr
進場	jìnchăng
進度	jìndù 
進而	jìnér 
進攻	jìngōng 
進化	jìnhuà 
進軍	jìnjūn 
進修	jìnxiū 
進展	jìnzhăn 
晉級	jìnjí 
盡量	jìnliàng
禁令	jìnlìng 
精	jīng 
精光	jīngguāng 
精華	jīnghuá 
精明	jīngmíng 
精髓	jīngsuǐ 
精緻	jīngzhì 
經典	jīngdiăn 
經濟	jīngjì 
經書	jīngshū 
驚惶	jīnghuáng 
驚奇	jīngqí 
驚喜	jīngxǐ 
驚險	jīngxiăn 
鯨魚	jīngyú 
井	jǐng 
警報	jǐngbào 
警覺	jǐngjué 
警惕	jǐngtì 
警衛	jǐngwèi 
景觀	jǐngguān 
景氣	jǐngqì 
景物	jǐngwù 
景象	jǐngxiàng 
淨	jìng 
竟	jìng 
敬	jìng 
敬佩	jìngpèi 
境地	jìngdì 
靜脈	jìngmài
靜態	jìngtài
競賽	jìngsài 
競選	jìngxuăn 
競爭	jìngzhēng
揪	jiū 
糾紛	jiūfēn 
酒店	jiŭdiàn 
酒館	jiŭguăn 
酒精	jiŭjīng 
就	jiù 
就緒	jiùxù 
救濟	jiùjì 
救援	jiùyuán 
居	jū 
局部	júbù 
局面	júmiàn 
沮喪	jŭsàng
舉例	jŭlì 
舉止	jŭzhǐ 
舉重	jŭzhòng 
巨人	jùrén 
拒	jù 
距	jù 
據	jù 
據悉	jùxī 
聚餐	jùcān 
俱全	jùquán 
捐獻	juānxiàn 
捐贈	juānzèng 
決賽	juésài 
決議	juéyì 
抉擇	juézé 
絕大多數	juédàduōshù 
絕跡	juéjī 
均	jūn 
均衡	jūnhéng 
均勻	jūnyún 
軍備	jūnbèi 
軍閥	jūnfá 
軍官	jūnguān 
軍艦	jūnjiàn 
開辦	kāibàn 
開導	kāidăo 
開動	kāidòng 
開發	kāifā
開飯	kāifàn 
開放	kāifàng 
開口	kāikǒu 
開闊	kāikuò 
開路	kāilù 
開幕	kāimù 
開盤	kāipán 
開闢	kāipì 
開啟	kāiqǐ 
開頭/開頭兒	kāitóu/kāitóur
開銷	kāixiāo 
開業	kāiyè 
開展	kāizhăn 
開張	kāizhāng 
刊物	kānwù
刊登	kāndēng 
看守	kānshǒu 
康復	kāngfù 
慷慨	kāngkăi 
扛	káng 
抗爭	kàngzhēng 
考場	kăochăng 
考古	kăogŭ 
考量	kǎoliáng
考生	kăoshēng 
考驗	kăoyàn 
烤肉	kǎoròu
靠	kào
刻畫/劃	kēhuà 
科幻	kēhuàn 
苛責	kēzé 
殼	ké 
可觀	kěguān 
可見	kějiàn 
可望	kěwàng 
可行	kěxíng 
刻薄	kèbó 
刻苦	kèkŭ 
刻意	kèyì 
客機	kèjī 
課業	kèyè 
克制	kèzhì 
吭聲	kēngshēng 
空	kōng
空曠	kōngkuàng 
空難	kōngnàn
空談	kōngtán 
空運	kōngyùn 
孔	kǒng 
恐嚇	kǒnghè 
恐懼	kǒngjù 
口	kŏu
口頭	kǒutóu 
口吻	kǒuwěn 
扣除	kòuchú 
苦工	kŭgōng 
苦難	kŭnàn
苦惱	kŭnăo 
苦衷	kŭzhōng 
庫存	kùcún 
誇	kuā 
誇耀	kuāyào 
跨越	kuàyuè 
快活	kuàihuó 
快速	kuàisù
寬廣	kuānguăng 
寬闊	kuānkuò 
款	kuăn 
款待	kuăndài 
款式	kuănshì 
狂風	kuángfēng 
狂妄	kuángwàng 
礦產	kuàngchăn 
礦工	kuànggōng
虧	kuī 
昆蟲	kūnchóng 
捆	kŭn 
困	kùn 
困境	kùnjìng 
困擾	kùnrăo 
困擾	kùnrǎo
擴建	kuòjiàn 
擴散	kuòsàn
擴張	kuòzhāng 
拉票	lāpiào 
臘月	làyuè 
來賓	láibīn 
來得	láide 
來客	láikè 
欄	lán
攔	lán 
懶惰	lănduò 
懶散	lănsàn
朗讀	lăngdú 
朗誦	lăngsòng 
浪費	làngfèi
牢	láo 
勞改	láogăi 
勞累	láolèi 
老年	lăonián 
老人家	lăorénjiā 
老鼠	lăoshŭ 
老天爺	lăotiānyé 
老頭兒/老頭子	lăotóur/lăotóuzi 
老鄉	lăoxiāng 
老子	lăozi
雷	léi 
雷達	léidá 
雷同	léitóng 
累積	lěijī
類似	lèisì 
類型	lèixíng 
冷凍	lěngdòng 
冷汗	lěnghàn 
冷門	lěngmén 
冷清	lěngqīng 
勒索	lèsuǒ 
哩	lī 
黎明	límíng 
罹難	línàn
里程	lǐchéng 
理財	lǐcái 
理論	lǐlùn 
理所當然	lǐsuǒdāngrán
理性	lǐxìng 
理學	lǐxué 
理智	lǐzhì 
禮服	lǐfú 
禮節	lǐjié 
禮貌	lǐmào 
力求	lìqiú 
力行	lìxíng 
力學	lìxué 
立國	lìguó 
立即	lìjí 
立體	lìtǐ 
利率	lìlǜ 
利弊	lìbì 
例	lì 
例	lì 
歷屆	lìjiè 
歷來	lìlái 
歷年	lìnián 
聯	lián 
聯	lián 
聯盟	liánméng 
聯繫	liánxì 
聯想	liánxiăng 
連帶	liándài 
連結	liánjié 
連任	liánrèn 
連線	liánxiàn 
廉價	liánjià 
廉潔	liánjié 
臉龐	liănpáng 
臉譜	liănpŭ 
良機	liángjī 
兩極	liăngjí 
兩口子	liăngkǒuzi 
遼闊	liáokuò 
列	liè 
列車	lièchē 
列國	lièguó 
列入	lièrù 
獵人	lièrén 
烈士	lièshì 
臨	lín 
臨	lín 
臨床	línchuáng 
鄰里	línlǐ 
鈴	líng 
靈	líng 
靈感	línggăn 
靈驗	língyàn 
領隊	lǐngduì 
領會	lǐnghuì 
領悟	lǐngwù 
令	lìng 
另	lìng 
溜冰	liūbīng 
留	liú
流程	liúchéng 
流傳	liúchuán 
流落	liúluò 
流氓	liúmáng 
流失	liúshī 
流水	liúshuǐ
流通	liútōng 
流星	liúxīng 
流域	liúyù 
柳樹	liŭshù 
籠子	lóngzi 
籠罩	lóngzhào 
壟斷	lǒngduàn 
樓房	lóufáng 
漏	lòu
爐子	lúzi 
陸地	lùdì 
路過	lùguò 
露天	lùtiān 
錄影	lùyǐng 
錄影機	lùyǐngjī
輪廓	lúnkuò 
倫理	lúnlǐ 
淪陷	lúnxiàn 
論	lùn 
論點	lùndiăn 
卵	luăn 
囉嗦(ㄙㄨㄛ˙)	luōsuo
鑼	luó 
邏輯	luójí 
落得	luòde 
落魄	luòtuò
落選	luòxuăn 
駱駝(ㄊㄨㄛ˙)	luòtuo
驢	lǘ
鋁	lǚ 
旅費	lǚfèi 
旅途	lǚtú 
旅行	lǚxíng
旅遊	lǚyóu
履歷	lǚlì
履行	lǚxíng 
略	lüè 
麻醉	 mázuì  
馬鈴薯	 mălíngshŭ  
埋伏	 máifú  
買賣	măimài 
買主	 măizhŭ  
邁	 mài  
邁進	 màijìn  
麥子	 màizi  
賣座	 màizuò  
瞞	 mán  
蠻橫	 mánhèng   
滿懷	 mănhuái  
漫長	 màncháng  
蔓延	 mànyán  
盲從	 mángcóng  
盲人	 mángrén  
芒果	 mángguǒ  
茫然	 mángrán  
毛毯	 máotăn  
茂密	 màomì  
冒險	 màoxiăn  
枚	 méi  
眉毛	 méimáo  
眉頭	 méitóu  
媒體	 méitǐ  
每每	 měiměi  
美滿	 měimăn  
美容院	 měiróngyuàn  
美食	měishí
美洲	měizhōu
悶	 mēn  
悶熱	 mēnrè  
門戶	 ménhù  
蒙	 méng  
猛	měng 
猛烈	 měngliè 
夢見	 mèngjiàn  
謎	 mí  
謎語	 míyŭ  
迷宮	 mígōng  
迷惑	 míhuò  
迷戀	 míliàn  
彌補	 míbŭ  
密集	 mìjí  
蜜	 mì  
鳴	 míng  
明白	 míngbái  
明理	 mínglǐ  
明日	 míngrì  
明智	 míngzhì  
名額	 míngé  
名號	 mínghào  
名氣	 míngqì  
名勝	 míngshèng  
名聲	 míngshēng  
名堂	 míngtáng  
名下	 míngxià  
冥想	 míngxiăng  
命名	 mìngmíng  
命中	 mìngzhòng 
綿延	 miányán  
勉強	miănqiăng 
免稅	 miănshuì  
免疫	 miănyì  
面孔	 miànkǒng  
面談	 miàntán  
描繪	 miáohuì  
描述	miáoshù
民俗	 mínsú  
民營	 mínyíng  
敏感	 mǐngăn  
敏捷	 mǐnjié  
滅	 miè  
模範	 mófàn   
模具	 mójù  
模式	 móshì  
魔術	 móshù  
末	 mò  
末期	 mòqí  
墨	 mò  
沒落	 mòluò  
沒收	 mòshōu  
默默	 mòmò  
默契	 mòqì  
漠視	 mòshì 
謀生	 móushēng  
某些	 mǒuxiē  
畝	 mŭ  
母語	mǔyǔ
木材	 mùcái  
木刻	 mùkē  
木料	 mùliào  
木偶	 mùǒu  
沐浴	 mùyù  
目睹	 mùdŭ  
目光	 mùguāng  
目擊	 mùjí  
牧場	 mùchăng  
幕	 mù  
募集	 mùjí  
拿	ná 
納悶	nàmèn 
納入	nàrù 
納稅	nàshuì 
乃	năi 
耐	nài 
耐力	nàilì 
男方	nánfāng 
南極洲	nánjízhōu
難度	nándù 
難關	nánguān 
難免	nánmiăn 
難題	nántí 
難民	nànmín
囊括	nángguā 
腦海	năohăi 
腦力	năolì 
內閣	nèigé 
內涵	nèihán 
內銷	nèixiāo 
內在	nèizài
內戰	nèizhàn 
內政	nèizhèng 
能量	néngliàng 
擬	nǐ 
擬定	nǐdìng 
膩	nì 
粘	nián 
念頭	niàntou
娘	niáng 
娘家	niángjiā 
凝固	nínggù 
凝結	níngjié 
凝聚	níngjù 
凝視	níngshì 
扭轉	niŭzhuăn 
農具	nóngjù 
農田	nóngtián 
農作物	nóngzuòwù 
弄錯	nòngcuò 
奴隸	núlì 
努力	nǔlì
怒氣	nùqì 
暖	nuăn 
挪	nuó 
懦弱	nuòruò 
諾言	nuòyán 
女方	nǚfāng 
虐待	nüèdài 
歐洲	ōuzhōu
偶而/爾	ǒuér/ ěr 
趴	pā 
拍馬屁	pāimăpì 
拍攝	pāishè 
拍照	pāizhào
拍子	pāizi 
排除	páichú 
排擠	páijǐ 
排名	páimíng 
派出所	pàichūsuǒ 
派對	pàiduì
派遣	pàiqiăn 
派頭	pàitóu 
判	pàn
盼	pàn 
旁人	pángrén 
旁聽	pángtīng 
拋	pāo 
拋棄	pāoqì 
跑道	păodào 
泡	pào 
泡沫	pàomò 
陪伴	péibàn
培訓	péixùn 
培育	péiyù 
配	pèi 
配	pèi 
配給	pèijǐ
配音	pèiyīn 
噴漆	pēnqī 
盆地	péndì 
蓬勃	péngbó 
捧場	pěngchăng 
批發	pīfā  
批准	pīzhŭn 
疲憊	píbèi 
匹	pǐ 
譬如	pìrú 
偏差	piānchā
便宜(一˙)	piányi
便宜(一˙)	piányi
片	piàn 
片刻	piànkè 
票	piào 
拼	pīn 
貧苦	pínkŭ 
貧民	pínmín 
品味	pǐnwèi 
品種	pǐnzhǒng 
乒乓球/桌球	pīnpāngqiú/zhuōqiú
平凡	píngfán 
平面	píngmiàn 
平穩	píngwěn 
平行	píngxíng 
評估	pínggū 
評價	píngjià 
評論	pínglùn 
潑	pō 
婆家	pójiā 
破案	pòàn 
破產	pòchăn 
破除	pòchú 
破獲	pòhuò 
破例	pòlì 
破碎	pòsuì 
迫害	pòhài 
魄力	pòlì 
樸素	púsù 
曝光	pùguāng 
暴露	pùlù 
漆	qī 
淒涼	qīliáng 
欺侮	qīwŭ 
奇觀	qíguān 
奇蹟	qíjī 
奇妙	qímiào 
奇異	qíyì 
期待	qídài
期貨	qíhuò 
期望	qíwàng 
旗幟	qízhì 
乞丐	qǐgài 
啟	qǐ 
啟發	qǐfā 
啟示	qǐshì 
啟事	qǐshì 
起步	qǐbù 
起伏	qǐfú 
起碼	qǐmă 
起源	qǐyuán 
氣概	qìgài 
氣管	qìguăn 
氣派	qìpài 
氣勢	qìshì 
氣體	qìtǐ 
氣壓	qìyā 
契機	qìjī 
棄權	qìquán 
恰當	qiàdàng 
恰好	qiàhăo 
恰恰	qiàqià 
洽商	qiàshāng 
洽談	qiàtán 
鉛	qiān 
牽連	qiānlián 
簽署	qiānshù 
千萬	qiānwàn
謙遜	qiānxùn 
前輩	qiánbèi 
前程	qiánchéng 
前後	qiánhòu 
前景	qiánjǐng 
前科	qiánkē 
前提	qiántí 
潛藏	qiáncáng 
潛力	qiánlì 
虔誠	qiánchéng 
淺薄	qiănbó 
淺顯	qiănxiăn 
腔調	qiāngdiào 
牆角	qiángjiăo 
強勁	qiángjìn 
強求	qiángqiú 
強權	qiángquán 
強壯	qiángzhuàng 
瞧不起	qiáobùqǐ 
橋樑	qiáoliáng 
巧合	qiăohé 
俏	qiào 
翹	qiào 
峭壁	qiàobì 
蹺課	qiàokè 
切磋	qiēcuō 
且	qiě 
且	qiě 
切實	qièshí 
竊賊	qièzéi 
親	qīn 
親熱	qīnrè 
親身	qīnshēn 
親生	qīnshēng 
侵犯	qīnfàn 
侵略	qīnlüè 
侵蝕	qīnshí 
侵襲	qīnxí 
欽佩	qīnpèi 
琴	qín 
勤奮	qínfèn 
青春	qīngchūn 
青翠	qīngcuì 
青蛙	qīngwā 
清澈	qīngchè 
清潔	qīngjié 
清靜	qīngjìng 
清廉	qīnglián 
清幽	qīngyōu 
清掃	qīngsăo 
傾向	qīngxiàng 
輕薄	qīngbó 
輕蔑	qīngmiè 
輕易	qīngyì 
情報	qíngbào 
情操	qíngcāo 
情婦	qíngfù 
情節	qíngjié 
情景	qíngjǐng 
情侶	qínglǚ 
情趣	qíngqù 
慶幸	qìngxìng 
丘陵	qiūlíng 
求學	qiúxué 
求助	qiúzhù 
屈服	qūfú 
趨勢	qūshì 
渠道	qúdào 
取材	qŭcái 
取締	qŭdì 
取樣	qŭyàng 
取悅	qŭyuè 
趣味	qùwèi 
圈	quān 
圈子	quānzi 
拳	quán 
全力	quánlì 
全盤	quánpán 
權力	quánlì 
權威	quánwēi 
權益	quányì 
泉源	quányuán 
勸導	quàndăo 
勸告	quàngào 
缺陷	quēxiàn 
確保	quèbăo 
確切	quèqiè 
確實	quèshí 
群島	qúndăo
群居	qúnjū 
染料	rănliào 
嚷	răng 
饒	ráo 
熱潮	rècháo 
熱帶	rèdài 
熱量	rèliàng 
熱水瓶	rèshuǐpíng 
仁愛	rénài 
人次	réncì 
人道	réndào 
人禍	rénhuò 
人際	rénjì
人情	rénqíng 
人群	rénqún 
人士	rénshì 
人手	rénshǒu 
人選	rénxuăn 
人造	rénzào 
忍痛	rěntòng 
任	rèn 
任期	rènqí 
任意	rènyì 
認錯	rèncuò 
認定	rèndìng 
日程	rìchéng 
日光燈	rìguāngdēng 
日益	rìyì 
容	róng 
容量	róngliàng 
容納	róngnà 
容器	róngqì 
容許	róngxŭ 
溶	róng 
溶化	rónghuà 
融合	rónghé 
融洽	róngqià
榮譽	róngyù 
揉	róu 
柔軟	róuruăn 
肉麻	ròumá 
肉體	ròutǐ 
如此	rúcĭ
儒家	rújiā 
入超	rùchāo
入口	rùkǒu 
入世	rùshì 
軟弱	ruănruò 
軟體	ruăntǐ 
若	ruò 
若干	ruògān 
撒謊	sāhuăng 
撒	să 
灑	să 
塞車	sāichē 
賽	sài 
散文	sănwén 
散布/佈	sànbù 
喪事	sāngshì 
嗓子	săngzi 
喪生	sàngshēng 
騷動	sāodòng 
嫂子	săozi 
色澤	sèzé 
剎/煞車	shāchē 
沙拉	shālā 
沙啞	shāyă 
傻瓜	shăguā 
山峰	shānfēng 
山谷	shāngŭ 
山脈	shānmài  
閃電	shăndiàn 
閃爍	shănshuò 
閃耀	shănyào 
擅長	shàncháng 
傷害	shānghài
傷口	shāngkǒu 
傷亡	shāngwáng 
商榷	shāngquè 
商討	shāngtăo 
賞	shăng 
尚	shàng 
上吊	shàngdiào 
上好	shànghăo 
上進	shàngjìn 
上空	shàngkōng 
上路	shànglù 
上門	shàngmén 
上司	shàngsī 
上下	shàngxià 
上旬	shàngxún 
上演	shàngyăn 
上癮	shàngyǐn 
上漲	shàngzhǎng
燒香	shāoxiāng 
奢侈	shēchǐ 
奢望	shēwàng 
設	shè 
設施	shèshī 
設想	shèxiăng 
射擊	shèjí 
射手	shèshǒu 
涉及	shèjí 
涉嫌	shèxián 
社論	shèlùn 
社區	shèqū
攝取	shèqŭ 
攝氏	shèshì 
攝影機	shèyǐngjī
深奧	shēnào 
深沉	shēnchén 
深度	shēndù 
深厚	shēnhòu 
深切	shēnqiè 
深入	shēnrù 
深造	shēnzào 
身段	shēnduàn 
身教	shēnjiào 
身為	shēnwéi
身子	shēnzi 
伸張	shēnzhāng 
神	shén 
神情	shénqíng 
審核	shěnhé 
審判	shěnpàn 
審慎	shěnshèn 
審議	shěnyì 
甚	shèn 
滲入	shènrù 
生詞	shēngcí
生火	shēnghuǒ 
生理	shēnglǐ 
生平	shēngpíng 
生氣	shēngqì 
生前	shēngqián 
生人	shēngrén 
生死	shēngsǐ 
生態	shēngtài 
生物	shēngwù 
生效	shēngxiào 
生硬	shēngyìng 
生育	shēngyù
生育	shēngyù
生殖	shēngzhí 
升遷	shēngqiān 
升值	shēngzhí 
聲稱	shēngchēng 
聲明	shēngmíng 
聲勢	shēngshì 
省	shěng
省事	shěngshì 
盛	shèng 
盛情	shèngqíng 
盛行	shèngxíng 
盛裝	shèngzhuāng 
勝地	shèngdì 
聖賢	shèngxián 
失	shī 
失靈	shīlíng 
失落	shīluò 
失明	shīmíng 
失事	shīshì 
失手	shīshǒu 
失蹤	shīzōng 
師範	shīfàn 
施肥	shīféi 
施行	shīxíng 
屍體	shītǐ 
石膏	shígāo 
十足	shízú 
拾	shí 
時差	shíchā
時光	shíguāng 
時節	shíjié 
時髦	shímáo 
時效	shíxiào 
實地	shídì 
實踐	shíjiàn 
實況	shíkuàng 
實例	shílì 
實習	shíxí 
實證	shízhèng 
實質	shízhí 
屎	shǐ 
史料	shǐliào 
使喚	shǐhuàn 
使節	shǐjié 
使勁	shǐjìn 
使命	shǐmìng 
士兵	shìbīng 
仕女	shìnǚ 
示範	shìfàn 
市面	shìmiàn 
市容	shìróng 
世代	shìdài 
世間	shìjiān 
世事	shìshì 
試卷	shìjuàn 
試圖	shìtú 
逝世	shìshì 
勢必	shìbì 
事故	shìgù 
事變	shìbiàn 
事態	shìtài 
事務	shìwù 
事宜	shìyí 
釋放	shìfàng 
嗜好	shìhào 
視為	shìwéi
室友	shìyǒu
適宜	shìyí 
適中	shìzhōng 
收藏	shōucáng 
收費	shōufèi 
收集	shōují 
收買	shōumăi 
收縮	shōusuō 
收聽	shōutīng 
收益	shōuyì 
手冊	shǒucè 
手槍	shǒuqiāng 
手勢	shǒushì 
守	shǒu
守護	shǒuhù 
首府	shǒufŭ 
首領	shǒulǐng 
首席	shǒuxí 
首飾	shǒushì 
首先	shǒuxiān
首長	shǒuzhǎng
受害	shòuhài 
受訓	shòuxùn 
售貨員	shòuhuòyuán 
授課	shòukè 
狩獵	shòuliè 
壽星	shòuxīng 
疏導	shūdăo 
疏散	shūsàn
梳	shū 
書本	shūběn 
書面	shūmiàn 
書寫	shūxiě 
舒暢	shūchàng 
舒展	shūzhăn 
輸血	shūxiě 
束縛	shùfú 
樹苗	shùmiáo 
數據	shùjù 
率	shuài 
霜	shuāng 
雙重	shuāngchóng 
雙打	shuāngdă 
爽快	shuăngkuài 
水道	shuǐdào 
水稻	shuǐdào 
水晶	shuǐjīng 
水庫	shuǐkù 
水力	shuǐlì 
水泥	shuǐní 
水源	shuǐyuán 
水蒸氣	shuǐzhēngqì 
睡眠	shuìmián 
順從	shùncóng
順應	shùnyìng
瞬間	shùnjiān 
說謊	shuōhuăng 
說笑	shuōxiào 
思潮	sīcháo 
思念	sīniàn 
思維	sīwéi 
絲毫	sīháo 
司令	sīlìng 
斯文	sīwén 
私心	sīxīn 
賜	sì 
似的/地	sìde
松樹	sōngshù 
慫恿	sǒngyǒng 
搜集	sōují 
俗稱	súchēng 
俗語	súyŭ 
塑膠	sùjiāo 
訴苦	sùkŭ 
素食	sùshí 
素質	sùzhí 
算命	suànmìng 
算術	suànshù 
雖說	suīshuō 
隨	suí 
隨	suí 
隨後	suíhòu 
隨即	suíjí 
隨身	suíshēn 
隨同	suítóng 
隧道	suìdào 
歲月	suìyuè 
損	sŭn 
損害	sŭnhài 
損壞	sŭnhuài 
損傷	sŭnshāng 
縮小	suōxiăo 
所得	suǒdé
所在	suǒzài 
索賠	suǒpéi 
瑣碎	suǒsuì 
牠	tā
他人	tārén 
塔	tă 
踏實	tàshí 
台	tái
台階	táijiē 
太極拳	tàijíquán 
太平	tàipíng 
態勢	tàishì 
貪	tān 
貪心	tānxīn 
攤位	tānwèi 
痰	tán 
談論	tánlùn 
彈性	tánxìng 
坦克	tănkè 
坦然	tănrán 
探病	tànbìng 
探究	tànjiù 
探索	tànsuǒ 
探望	tànwàng 
探險	tànxiăn 
湯圓	tāngyuán 
堂堂	tángtáng 
倘若	tăngruò 
陶器	táoqì 
逃生	táoshēng 
逃稅	táoshuì 
淘汰	táotài 
套房	tàofáng
套裝	tàozhuāng 
特此	tècǐ 
特區	tèqū 
特權	tèquán 
特約	tèyuē 
特徵	tèzhēng
疼愛	téngài 
剔除	tīchú 
啼	tí 
提拔	tíbá 
提倡	tíchàng 
提出	tíchū 
提及	tíjí 
提名	tímíng 
提升	tíshēng 
提議	tíyì 
體操	tǐcāo 
體格	tǐgé 
體積	tǐjī 
體諒	tǐliàng 
體面	tǐmiàn 
體系	tǐxì 
體質	tǐzhí 
替代	tìdài 
添	tiān 
天敵	tiāndí 
天然氣	tiānránqì 
天性	tiānxìng 
天災	tiānzāi 
田地	tiándì 
田徑	tiánjìng 
甜美	tiánměi 
挑剔	tiāotī 
調和	tiáohé 
調和	tiáohé 
調節	tiáojié 
調皮	tiáopí 
條例	tiáolì 
挑戰	tiǎozhàn
聽寫	tīngxiě 
停頓	tíngdùn 
停留	tíngliú 
停滯	tíngzhì 
通	tōng 
通報	tōngbào 
通車	tōngchē 
通稱	tōngchēng 
通貨膨脹	tōnghuòpéngzhàng 
通緝	tōngqì 
通行	tōngxíng 
通用	tōngyòng 
同伴	tóngbàn 
同化	tónghuà 
同鄉	tóngxiāng 
同心	tóngxīn 
同性戀	tóngxìngliàn 
同業	tóngyè 
統計	tǒngjì
統統	tǒngtǒng 
統制	tǒngzhì 
痛恨	tònghèn 
偷渡	tōudù 
偷懶	tōulăn 
投保	tóubăo 
投機	tóujī 
投入	tóurù 
透明	tòumíng 
徒弟	túdì 
突擊	tújí 
突兀	túwù 
塗	tú 
圖	tú 
圖表	túbiǎo
圖畫	túhuà 
圖騰	túténg 
土壤	tŭrăng 
團	tuán
團聚	tuánjù 
團員	tuányuán 
推測	tuīcè 
推崇	tuīchóng 
推出	tuīchū 
推選	tuīxuăn 
退化	tuìhuà 
吞吞吐吐	tūntūntŭtŭ 
托	tuō 
拖	tuō 
拖累	tuōlèi 
拖延	tuōyán 
脫身	tuōshēn 
脫手	tuōshǒu 
瓦斯	wăsī 
外表	wàibiǎo
外號	wàihào 
外力	wàilì 
外貿	wàimào 
外線	wàixiàn 
外銷	wàixiāo 
外遇	wàiyù 
外在	wàizài 
外資	wàizī 
外祖父	wàizŭfù 
外祖母	wàizŭmŭ 
彎曲	wānqū 
完備	wánbèi 
完美	wánměi
玩弄	wánnòng 
頑強	wánqiáng 
挽	wăn 
挽救	wănjiù 
萬分	wànfēn 
萬事	wànshì
萬歲	wànsuì 
萬萬	wànwàn 
萬物	wànwù 
惋惜	wànxí 
亡國	wángguó 
往來	wănglái 
旺季	wàngjì 
旺盛	wàngshèng 
威風	wēifēng 
威力	wēilì 
萎縮	wēisuō
為	wéi 
為人	wéirén
為生	wéishēng 
為首	wéishǒu 
為止	wéizhǐ
違背	wéibèi 
違約	wéiyuē 
危害	wéihài 
圍巾	wéijīn 
圍牆	wéiqiáng 
圍繞	wéirào 
微弱	wéiruò 
微小	wéixiăo 
維生素	wéishēngsù 
胃	wèi 
胃口	wèikǒu 
未必	wèibì 
未婚夫	wèihūnfū 
未婚妻	wèihūnqī 
未免	wèimiăn 
衛生	wèishēng
溫	wēn 
溫帶	wēndài 
溫泉	wēnquán 
溫習	wēnxí 
溫馴	wēnxún 
瘟疫	wēnyì 
文明	wénmíng
文壇	wéntán 
文獻	wénxiàn 
聞名	wénmíng 
穩健	wěnjiàn 
紊亂	wènluàn 
問世	wènshì 
臥	wò 
烏龜	wūguī 
烏龍茶	wūlóngchá 
烏鴉	wūyā 
汙染/污染	wūrǎn
無比	wúbǐ 
無線電	wúxiàndiàn 
無形	wúxíng
無疑	wúyí 
五金	wŭjīn 
武力	wŭlì 
武士	wŭshì 
武裝	wŭzhuāng 
侮辱	wŭrù 
物產	wùchăn 
物品	wùpǐn 
物體	wùtǐ 
物資	wùzī 
誤差	wùchā
誤解	wùjiě 
務實	wùshí 
西服	xīfú 
西洋	xīyáng 
西醫	xīyī 
溪流	xīliú 
席	xí 
席位	xíwèi 
錫	xí 
襲擊	xíjí 
昔日	xírì  
習題	xítí 
洗禮	xǐlǐ 
喜氣	xǐqì 
喜悅	xǐyuè 
系	xì
戲曲	xìqŭ 
瑕疵	xiácī 
峽谷	xiágŭ 
狹小	xiáxiăo 
狹窄	xiázhăi 
下筆	xiàbǐ 
下跌	xiàdié 
下滑	xiàhuá
下列	xiàliè 
下水	xiàshuǐ 
下水道	xiàshuǐdào 
下旬	xiàxún 
掀	xiān 
仙丹	xiāndān 
先後	xiānhòu 
先進	xiānjìn 
先驅	xiānqū 
先天	xiāntiān 
鮮明	xiānmíng 
鮮艶/豔	xiānyàn 
纖維	xiānwéi 
嫌疑	xiányí 
顯現	xiănxiàn 
限	xiàn 
限度	xiàndù 
憲法	xiànfă 
線路	xiànlù 
陷入	xiànrù 
獻身	xiànshēn 
現今	xiànjīn
現行	xiànxíng 
現狀	xiànzhuàng 
相傳	xiāngchuán 
相仿	xiāngfăng 
相符	xiāngfú 
相繼	xiāngjì 
相配	xiāngpèi 
鄉土	xiāngtŭ 
香皂	xiāngzào 
鑲	xiāng 
想開	xiăngkāi 
響亮	xiăngliàng 
向	xiàng 
項	xiàng 
嚮導	xiàngdăo 
嚮往	xiàngwăng 
象徵	xiàngzhēng 
象徵	xiàngzhēng 
消毒	xiāodú 
消防	xiāofáng 
消耗	xiāohào 
消遣	xiāoqiăn 
消遣	xiāoqiăn 
瀟灑	xiāosă 
逍遙	xiāoyáo 
小販	xiăofàn 
小伙/夥子	xiăohuǒzi 
效法	xiàofă 
效勞	xiàoláo 
效力	xiàolì 
效忠	xiàozhōng 
笑嘻嘻	xiàoxīxī 
孝子	xiàozǐ 
協辦	xiébàn 
協定	xiédìng 
協會	xiéhuì 
協商	xiéshāng 
協調	xiétiáo 
協調	xiétiáo 
協議	xiéyì 
協議	xiéyì 
血汗	xiěhàn 
血跡	xiějī 
血壓	xiěyā 
寫實	xiěshí 
寫作	xiězuò 
洩氣	xièqì 
心愛	xīnài 
心軟	xīnruăn 
心事	xīnshì 
心思	xīnsī 
心酸	xīnsuān 
心態	xīntài 
心疼	xīnténg 
心胸	xīnxiōng 
辛勤	xīnqín 
辛酸	xīnsuān 
新潮	xīncháo 
新手	xīnshǒu 
新穎	xīnyǐng 
信賴	xìnlài 
信念	xìnniàn 
信徒	xìntú 
信息	xìnxí 
星辰	xīngchén 
星座	xīngzuò 
興建	xīngjiàn
興隆	xīnglóng 
興起	xīngqǐ 
行善	xíngshàn 
行使	xíngshǐ 
行星	xíngxīng 
行政	xíngzhèng 
刑事	xíngshì 
形勢	xíngshì 
形態	xíngtài 
形體	xíngtǐ 
形形色色	xíngxíngsèsè 
型態	xíngtài 
性	xìng
性能	xìngnéng 
性情	xìngqíng 
興致	xìngzhì 
胸	xiōng 
胸口	xiōngkǒu 
修補	xiūbŭ 
修訂	xiūdìng 
修建	xiūjiàn 
修女	xiūnǚ 
修養	xiūyăng 
修築	xiūzhú 
繡	xiù 
須	xū 
虛擬	xūnǐ 
虛心	xūxīn 
許	xŭ
許多	xŭduō 
許久	xŭjiŭ 
許可	xŭkě 
酗酒	xùjiŭ 
序幕	xùmù 
敘述	xùshù 
宣稱	xuānchēng 
宣告	xuāngào 
宣示	xuānshì 
宣誓	xuānshì 
宣言	xuānyán 
宣揚	xuānyáng 
旋律	xuánlǜ
旋轉	xuánzhuăn 
懸殊	xuánshū 
懸崖	xuányái 
選拔	xuănbá 
選購	xuăngòu 
選民	xuănmín 
選票	xuănpiào 
選修	xuănxiū 
學分	xuéfēn 
學科	xuékē 
學年	xuénián 
學識	xuéshì 
學說	xuéshuō 
學徒	xuétú 
學員	xuéyuán 
學制	xuézhì 
雪人	xuěrén 
削弱	xuèruò 
循環	xúnhuán 
巡邏	xúnluó 
巡視	xúnshì 
詢問	xúnwèn 
訓	xùn 
押	yā 
鴉片	yāpiàn 
壓歲錢	yāsuìqián 
壓縮	yāsuō 
壓制	yāzhì 
牙科	yákē 
芽	yá 
啞	yă 
亞軍	yàjūn 
亞洲	yàzhōu
淹	yān 
研究所	yánjiùsuǒ
言論	yánlùn 
岩石	yánshí 
延遲	yánchí 
延伸	yánshēn 
延誤	yánwù 
延續	yánxù 
沿海	yánhăi 
沿途	yántú 
沿襲	yánxí 
沿用	yányòng 
嚴禁	yánjìn 
嚴厲	yánlì 
嚴密	yánmì 
演變	yănbiàn 
演講	yǎnjiǎng
演說	yănshuō 
演習	yănxí 
眼界	yănjiè 
眼看	yănkàn 
衍生	yănshēng 
燕窩	yànwō 
燕子	yànzi 
央求	yāngqiú 
仰	yăng 
仰慕	yăngmù 
養分	yăngfèn  
養老	yănglăo 
養育	yǎngyù
邀	yāo 
窯	yáo 
搖晃(ㄏㄨㄤ˙)	yáohuang 
謠言	yáoyán 
遙遠	yáoyuăn 
要點	yàodiăn 
要犯	yàofàn 
藥品	yàopǐn 
葉	yè 
業績	yèjī 
依	yī 
依舊	yījiù 
依據	yījù 
依賴	yīlài 
依照	yīzhào 
醫療	yīliáo
醫術	yīshù 
醫藥	yīyào 
一定	yīdìng
一道	yídào 
一度	yídù 
一概	yígài 
一貫	yíguàn 
一律	yílǜ
一味	yíwèi 
咦	yí 
儀表	yíbiăo 
遺產	yíchăn 
遺傳	yíchuán 
遺憾	yíhàn 
遺留	yíliú 
遺棄	yíqì 
遺體	yítǐ 
遺忘	yíwàng 
遺志	yízhì 
遺址	yízhǐ 
疑慮	yílǜ
移植	yízhí 
倚	yǐ 
以至/致(於)	yǐzhì(yú)  
亦	yì 
亦	yì 
一連串	yìliánchuàn 
一流	yìliú 
一如	yìrú 
一心	yìxīn 
液體	yètǐ
抑制	yìzhì 
意識到	yìshìdào 
意圖	yìtú 
意味	yìwèi 
毅力	yìlì 
翌日	yìrì 
異常	yìcháng 
異鄉	yìxiāng 
議定	yìdìng 
議論	yìlùn 
議題	yìtí 
議員	yìyuán 
音	yīn
因果	yīnguǒ 
陰謀	yīnmóu 
陰影	yīnyǐng
銀幕	yínmù
銀色	yínsè 
銀子	yínzi 
引	yǐn 
引導	yǐndăo 
引進	yǐnjìn 
引擎	yǐnqíng 
隱藏	yǐncáng 
隱士	yǐnshì 
隱約	yǐnyuē 
印證	yìnzhèng 
櫻桃	yīngtáo 
英勇	yīngyǒng 
英語	yīngyǔ
應	yīng 
應	yìng 
鷹	yīng  
營地	yíngdì 
營造	yíngzào 
迎	yíng 
迎合	yínghé 
影射	yǐngshè 
硬	yìng 
硬體	yìngtǐ
應變	yìngbiàn 
應酬	yìngchóu 
應急	yìngjí 
應驗	yìngyàn 
應徵	yìngzhēng 
唷	yō 
湧	yǒng 
踴躍	yǒngyuè 
用戶	yònghù 
用途	yòngtú 
用心	yòngxīn 
悠久	yōujiŭ 
悠閒	yōuxián 
優待	yōudài 
優勢	yōushì 
優先	yōuxiān 
優異	yōuyì 
鈾	yóu 
由來	yóulái 
遊覽	yóulăn 
油田	yóutián 
油條	yóutiáo 
友愛	yǒuài 
有機	yǒujī 
有理	yǒulǐ 
有所	yǒusuǒ
有為	yǒuwéi 
有限	yǒuxiàn 
有形	yǒuxíng 
有心人	yǒuxīnrén 
有益	yǒuyì 
有意	yǒuyì 
有緣	yǒuyuán 
誘惑	yòuhuò
幼稚	yòuzhì 
于	yú 
於	yú 
逾	yú 
餘	yú 
餘	yú 
愚蠢	yúchŭn 
輿論	yúlùn 
漁民	yúmín 
予	yŭ 
予以	yŭyǐ 
與會	yŭhuì 
雨季	yŭjì 
語文	yŭwén 
宇宙	yŭzhòu 
愈	yù
玉器	yùqì 
預測	yùcè 
預防	yùfáng 
預告	yùgào 
預估	yùgū 
預賽	yùsài 
預約	yùyuē 
寓言	yùyán 
園林	yuánlín 
元氣	yuánqì 
元首	yuánshǒu 
元素	yuánsù 
原	yuán 
原本	yuánběn
原形	yuánxíng 
原野	yuányě 
原狀	yuánzhuàng 
原住民	yuánzhùmín
原子	yuánzǐ  
原子彈	yuánzǐdàn 
援助	yuánzhù 
遠景	yuănjǐng 
怨	yuàn 
約束	yuēshù 
躍	yuè 
樂隊	yuèduì 
月台	yuètái 
運	yùn
運行	yùnxíng 
孕婦	yùnfù 
醞釀	yùnniàng 
栽	zāi 
災禍	zāihuò 
災情	zāiqíng 
在場	zàichăng 
在世	zàishì 
在座	zàizuò 
再三	zàisān 
再生	zàishēng 
咱	zán 
贊助	zànzhù 
讚嘆/歎	zàntàn 
贓物	zāngwù 
遭	zāo 
遭	zāo 
遭	zāo 
遭遇	zāoyù
造反	zàofăn 
造化	zàohuà 
造物主	zàowùzhŭ 
造型	zàoxíng 
責備	zébèi 
增進	zēngjìn 
增強	zēngqiáng 
增值	zēngzhí
贈	zèng 
扎	zhā
炸藥	zhàyào
沾	zhān 
盞	zhăn 
展望	zhănwàng 
展現	zhănxiàn 
嶄新	zhănxīn 
占/佔據	zhànjù 
占/佔領	zhànlǐng 
顫抖	zhàndǒu 
戰火	zhànhuǒ 
戰機	zhànjī 
戰亂	zhànluàn 
戰略	zhànlüè 
戰勝	zhànshèng 
戰士	zhànshì 
戰術	zhànshù 
戰線	zhànxiàn 
戰友	zhànyǒu 
戰戰兢兢	zhànzhànjīngjīng 
張開	zhāngkāi 
張貼	zhāngtiē 
長子	zhǎngzǐ
帳篷	zhàngpéng 
丈	zhàng 
朝氣	zhāoqì 
著想	zháoxiăng 
找尋	zhăoxún 
沼澤	zhăozé 
召集	zhàojí 
照例	zhàolì 
照耀	zhàoyào 
遮	zhē 
遮蔽	zhēbì 
折騰	zhēténg 
針灸	zhēnjiŭ 
真情	zhēnqíng 
診斷	zhěnduàn 
診所	zhěnsuǒ 
鎮定	zhèndìng 
鎮壓	zhènyā 
振動	zhèndòng 
震驚	zhènjīng 
陣營	zhènyíng 
蒸	zhēng 
蒸發	zhēngfā 
蒸氣	zhēngqì 
爭辯	zhēngbiàn 
爭奪	zhēngduó 
爭論	zhēnglùn 
爭氣	zhēngqì 
爭議	zhēngyì 
徵收	zhēngshōu 
掙扎	zhēngzhá 
整	zhěng 
整頓	zhěngdùn 
整體	zhěngtǐ 
整整	zhěngzhěng 
正當	zhèngdāng 
正面	zhèngmiàn 
正統	zhèngtǒng 
正義	zhèngyì 
政績	zhèngjī 
政見	zhèngjiàn 
政權	zhèngquán 
證券	zhèngquàn 
證人	zhèngrén 
掙	zhèng
之內	zhīnèi 
之所以	zhīsuǒyǐ
支撐	zhīchēng 
支付	zhīfù 
支配	zhīpèi 
支應	zhīyìng
知足	zhīzú 
脂肪	zhīfáng 
織	zhī 
直徑	zhíjìng 
值班	zhíbān 
值錢	zhíqián 
殖民	zhímín 
質量	zhíliàng 
質疑	zhíyí 
職務	zhíwù 
職責	zhízé 
執照	zhízhào 
執政	zhízhèng 
執著	zhízhuó
止	zhĭ
只得	zhǐděi
指標	zhǐbiāo 
指點	zhǐdiăn 
指揮	zhǐhuī 
指揮	zhǐhuī 
指控	zhǐkòng 
指南針	zhǐnánzhēn 
指數	zhǐshù 
指頭	zhǐtou
指望	zhǐwàng 
指紋	zhǐwén 
指引	zhǐyǐn 
指正	zhǐzhèng 
至	zhì
至	zhì 
至今	zhìjīn 
治安	zhìān 
治本	zhìběn 
治標	zhìbiāo 
治理	zhìlǐ 
治療	zhìliáo 
志趣	zhìqù 
志向	zhìxiàng 
致詞	zhìcí 
致富	zhìfù 
致力	zhìlì 
致命	zhìmìng 
致意	zhìyì 
智力	zhìlì 
制裁	zhìcái 
制訂	zhìdìng 
製品	zhìpǐn 
滯留	zhìliú 
中斷	zhōngduàn 
中和	zhōnghé 
中立	zhōnglì 
中旬	zhōngxún 
中葉	zhōngyè 
中醫	zhōngyī 
中庸	zhōngyōng 
忠實	zhōngshí 
衷心	zhōngxīn 
終場	zhōngchăng 
終結	zhōngjié 
終究	zhōngjiù 
終身	zhōngshēn 
種種	zhǒngzhǒng
種植	zhòngzhí 
中風	zhòngfēng 
中獎	zhòngjiăng 
中肯	zhòngkěn
中暑	zhòngshŭ 
重用	zhòngyòng 
重鎮	zhòngzhèn 
周邊	zhōubiān 
周密	zhōumì 
周詳	zhōuxiáng 
周遊	zhōuyóu 
周轉	zhōuzhuăn 
皺	zhòu 
皺紋	zhòuwén 
株	zhū 
諸多	zhūduō 
逐	zhú 
逐	zhú 
逐步	zhúbù 
主導	zhŭdăo 
主管	zhŭguăn 
主見	zhŭjiàn 
主力	zhŭlì 
主流	zhŭliú 
主權	zhŭquán 
主人翁	zhŭrénwēng 
主義	zhŭyì 
主宰	zhŭzăi 
主旨	zhŭzhǐ 
主軸	zhŭzhóu 
囑咐	zhŭfù 
矚目	zhŭmù 
注定	zhùdìng 
注目	zhùmù 
注視	zhùshì 
注重	zhùzhòng 
住戶	zhùhù 
住宿	zhùsù 
柱子	zhùzi 
助教	zhùjiào 
助手	zhùshǒu 
佇立	zhùlì 
著作	zhùzuò 
駐	zhù 
抓緊	zhuājǐn 
專櫃	zhuānguì 
專員	zhuānyuán 
專制	zhuānzhì 
磚	zhuān 
轉動	zhuăndòng 
轉化	zhuănhuà 
轉機	zhuănjī 
轉手	zhuănshǒu 
轉向	zhuănxiàng 
轉眼	zhuănyăn 
轉移	zhuănyí 
轉帳	zhuănzhàng 
撰寫	zhuànxiě 
莊嚴	zhuāngyán 
裝備	zhuāngbèi 
裝潢	zhuānghuáng 
裝配	zhuāngpèi 
裝運	zhuāngyùn 
裝置	zhuāngzhì 
壯觀	zhuàngguān 
壯麗	zhuànglì 
狀元	zhuàngyuán 
追捕	zhuībŭ 
追查	zhuīchá 
追究	zhuījiù 
準	zhŭn 
準備	zhǔnbèi
準則	zhŭnzé 
准許	zhŭnxŭ 
卓越	zhuóyuè 
著手	zhuóshǒu 
著眼	zhuóyăn 
著重	zhuózhòng 
酌量	zhuóliàng 
資深	zīshēn 
資助	zīzhù 
姿勢	zīshì 
姿態	zītài 
滋味	zīwèi 
子彈	zǐdàn 
子弟	zǐdì 
子孫	zǐsūn 
紫外線	zǐwàixiàn 
自	zì 
自稱	zìchēng 
自費	zìfèi 
自豪	zìháo 
自覺	zìjué 
自立	zìlì 
自滿	zìmăn 
自然	zìrán
自身	zìshēn 
自行	zìxíng 
自制	zìzhì 
自治	zìzhì 
自傳	zìzhuàn
字體	zìtǐ 
字眼/字眼兒	zìyăn/zìyănr
字樣	zìyàng 
宗旨	zōngzhǐ 
總裁	zǒngcái 
總得	zǒngděi 
總額	zǒngé 
總和	zǒnghé 
總結	zǒngjié 
總經理	zǒngjīnglǐ 
總數	zǒngshù 
縱火	zònghuǒ 
縱容	zòngróng
縱使	zòngshǐ 
走廊	zǒuláng 
揍	zòu 
租賃	zūlìn 
足	zú 
足夠	zúgòu
祖宗	zŭzōng 
阻擋	zŭdăng 
阻力	zŭlì 
阻撓	zŭnáo 
阻塞	zŭsè 
組織	zŭzhī 
組裝	zŭzhuāng 
鑽研	zuānyán 
嘴唇	zuǐchún 
罪惡	zuìè 
罪名	zuìmíng 
罪行	zuìxíng 
尊	zūn 
尊	zūn 
尊嚴	zūnyán 
遵循	zūnxún 
作風	zuòfēng 
作怪	zuòguài 
作為	zuòwéi 
作物	zuòwù 
作戰	zuòzhàn 
作證	zuòzhèng 
坐牢	zuòláo 
坐鎮	zuòzhèn 
座談	zuòtán 
座右銘	zuòyòumíng 