the	ðiː 	thē 
you	juː 	yü 
i	aɪ 	ī 
a	eɪ 	ā 
to	tuː 	tū 
and	ænd 	and 
it	ɪt 	it 
what	wɒt 	wot 
of	ɒv 	ov 
that	ðæt 	that 
is	ɪz 	iz 
in	ɪn 	in 
oh	əʊ 	əoo 
this	ðɪs 	this 
me	miː 	mē 
don't	dəʊnt 	dəoont 
we	wiː 	wē 
no	nəʊ 	nəoo 
all	ɔːl 	ôl 
it's	ɪts 	its 
on	ɒn 	on 
get	gɛt 	gét 
here	hɪə 	hēə 
your	jɔː 	yô 
right	raɪt 	rīt 
i'm	aɪm 	īm 
are	ɑː 	ä 
go	gəʊ 	gəoo 
for	fɔː 	fô 
that's	ðæts 	thats 
chicken	ˈʧɪkɪn 	chikin 
like	laɪk 	līk 
out	aʊt 	owt 
have	hæv 	hav 
up	ʌp 	up 
my	maɪ 	mī 
us	ʌs 	us 
just	ʤʌst 	yust 
do	duː 	dū 
but	bʌt 	but 
be	biː 	bē 
now	naʊ 	now 
fly	flaɪ 	flī 
so	səʊ 	səoo 
egg	ɛg 	ég 
give	gɪv 	giv 
come	kʌm 	kum 
say	seɪ 	sā 
eggs	ɛgz 	égz 
one	wʌn 	wun 
about	əˈbaʊt 	əbowt 
was	wɒz 	woz 
good	gʊd 	good 
if	ɪf 	if 
you're	jʊə 	yüə 
there	ðeə 	thã 
how	haʊ 	how 
with	wɪð 	with 
yeah	jeə 	yã 
ever	ˈɛvə 	évə 
what's	wɒts 	wots 
not	nɒt 	not 
more	mɔː 	mô 
we're	wɪə 	wēə 
they	ðeɪ 	thā 
over	ˈəʊvə 	əoovə 
from	frɒm 	from 
see	siː 	sē 
they're	ðeə 	thã 
know	nəʊ 	nəoo 
he	hiː 	hē 
going	ˈgəʊɪŋ 	gəooing 
back	bæk 	bak 
well	wɛl 	wél 
then	ðɛn 	thén 
yes	jɛs 	yés 
ginger	ˈʤɪnʤə 	yinyə 
look	lʊk 	look 
as	æz 	az 
got	gɒt 	got 
will	wɪl 	wil 
i'll	aɪl 	īl 
first	fɜːst 	fûst 
work	wɜːk 	wûk 
can't	kɑːnt 	känt 
them	ðɛm 	thém 
uh	ʌ 	u 
time	taɪm 	tīm 
head	hɛd 	héd 
chickens	ˈʧɪkɪnz 	chikinz 
at	æt 	at 
fowler	ˈfaʊlə 	fowlə 
tweedy	tweedy 	tweedy 
let's	lɛts 	léts 
she	ʃiː 	shē 
some	sʌm 	sum 
didn't	dɪdnt 	didnt 
i've	aɪv 	īv 
mr	mr 	mr 
die	daɪ 	dī 
care	keə 	kã 
where	weə 	wã 
our	ˈaʊə 	owə 
way	weɪ 	wā 
gonna	ˈgənə 	gənə 
can	kæn 	kan 
her	hɜː 	hû 
why	waɪ 	wī 
babs	babs 	babs 
mean	miːn 	mēn 
long	lɒŋ 	long 
an	æn 	an 
wing	wɪŋ 	wing 
flying	ˈflaɪɪŋ 	flīing 
day	deɪ 	dā 
tell	tɛl 	tél 
plan	plæn 	plan 
old	əʊld 	əoold 
isn't	ˈɪznt 	iznt 
farm	fɑːm 	fäm 
good-bye	gʊd-baɪ 	good-bī 
leave	liːv 	lēv 
flop	flɒp 	flop 
hey	heɪ 	hā 
into	ˈɪntuː 	intū 
thing	θɪŋ 	thing 
rocky	ˈrɒki 	rokē 
we'll	wiːl 	wēl 
him	hɪm 	him 
been	biːn 	bēn 
trying	ˈtraɪɪŋ 	trīing 
think	θɪŋk 	thingk 
show	ʃəʊ 	shəoo 
never	ˈnɛvə 	névə 
those	ðəʊz 	thəooz 
off	ɒf 	of 
would	wʊd 	wood 
want	wɒnt 	wont 
when	wɛn 	wén 
call	kɔːl 	kôl 
pies	paɪz 	pīz 
flip	flɪp 	flip 
mrs	mrs 	mrs 
really	ˈrɪəli 	rēəlē 
wait	weɪt 	wāt 
lay	leɪ 	lā 
great	greɪt 	grāt 
free	friː 	frē 
he's	hiːz 	hēz 
there's	ðeəz 	thãz 
were	wɜː 	wû 
down	daʊn 	down 
keep	kiːp 	kēp 
quiet	ˈkwaɪət 	kwīət 
something	ˈsʌmθɪŋ 	sumthing 
two	tuː 	tū 
need	niːd 	nēd 
we've	wiːv 	wēv 
coming	ˈkʌmɪŋ 	kuming 
baby	ˈbeɪbi 	bābē 
flew	fluː 	flū 
stop	stɒp 	stop 
hide	haɪd 	hīd 
around	əˈraʊnd 	ərownd 
hard	hɑːd 	häd 
which	wɪʧ 	wich 
okay	ˈəʊˈkeɪ 	əookā 
did	dɪd 	did 
course	kɔːs 	kôs 
rhodes	ˈrəʊdz 	rəoodz 
very	ˈvɛri 	vérē 
his	hɪz 	hiz 
grass	grɑːs 	gräs 
better	ˈbɛtə 	bétə 
because	bɪˈkɒz 	bikoz 
always	ˈɔːlweɪz 	ôlwāz 
still	stɪl 	stil 
bunty	bunty 	būnty 
away	əˈweɪ 	əwā 
love	lʌv 	luv 
thrust	θrʌst 	thrust 
bunk	bʌŋk 	bungk 
tomorrow	təˈmɒrəʊ 	təmorəoo 
every	ˈɛvri 	évrē 
has	hæz 	haz 
life	laɪf 	līf 
take	teɪk 	tāk 
please	pliːz 	plēz 
everyone	ˈɛvrɪwʌn 	évriwun 
she's	ʃiːz 	shēz 
could	kʊd 	kood 
mac	mæk 	mak 
bit	bɪt 	bit 
holiday	ˈhɒlədeɪ 	holədā 
let	lɛt 	lét 
make	meɪk 	māk 
teach	tiːʧ 	tēch 
deal	diːl 	dēl 
doing	ˈdu(ː)ɪŋ 	dūing 
kiss	kɪs 	kis 
sorry	ˈsɒri 	sorē 
aye	eɪ 	ā 
flap	flæp 	flap 
little	ˈlɪtl 	litl 
side	saɪd 	sīd 
hold	həʊld 	həoold 
kill	kɪl 	kil 
listen	ˈlɪsn 	lisn 
answer	ˈɑːnsə 	änsə 
um	əm 	əm 
exactly	ɪgˈzæktli 	igzaktlē 
yank	jæŋk 	yangk 
face	feɪs 	fās 
does	dʌz 	duz 
who	huː 	hū 
problem	ˈprɒbləm 	probləm 
might	maɪt 	mīt 
haven't	hævnt 	havnt 
real	rɪəl 	rēəl 
three	θriː 	thrē 
too	tuː 	tū 
these	ðiːz 	thēz 
thank	θæŋk 	thangk 
things	θɪŋz 	thingz 
hen	hɛn 	hén 
crate	kreɪt 	krāt 
f	ɛf 	éf 
r	ɑː 	ä 
left	lɛft 	léft 
along	əˈlɒŋ 	əlong 
comes	kʌmz 	kumz 
bye-bye	ˈbaɪbaɪ 	bībī 
without	wɪˈðaʊt 	withowt 
guys	gaɪz 	gīz 
other	ˈʌðə 	uthə 
fine	faɪn 	fīn 
put	pʊt 	poot 
shall	ʃæl 	shal 
feeling	ˈfiːlɪŋ 	fēling 
everything	ˈɛvrɪθɪŋ 	évrithing 
turn	tɜːn 	tûn 
wanna	ˈwɒnə 	wonə 
roam	rəʊm 	rəoom 
worry	ˈwʌri 	wurē 
doll	dɒl 	dol 
name	neɪm 	nām 
lone	ləʊn 	ləoon 
fact	fækt 	fakt 
done	dʌn 	dun 
dollface	dollface 	dollface 
ain't	eɪnt 	ānt 
pops	pɒps 	pops 
easy	ˈiːzi 	ēzē 
together	təˈgɛðə 	təgéthə 
start	stɑːt 	stät 
ladies	ˈleɪdɪz 	lādiz 
help	hɛlp 	hélp 
am	æm 	am 
place	pleɪs 	plās 
heads	hɛdz 	hédz 
round	raʊnd 	rownd 
getting	ˈgɛtɪŋ 	géting 
perhaps	pəˈhæps 	pəhaps 
most	məʊst 	məoost 
stupid	ˈstjuːpɪd 	styüpid 
same	seɪm 	sām 
making	ˈmeɪkɪŋ 	māking 
or	ɔː 	ô 
miss	mɪs 	mis 
word	wɜːd 	wûd 
under	ˈʌndə 	undə 
tried	traɪd 	trīd 
chocks	ʧɒks 	choks 
hop	hɒp 	hop 
officer	ˈɒfɪsə 	ofisə 
days	deɪz 	dāz 
order	ˈɔːdə 	ôdə 
ya	jə 	yə 
fence	fɛns 	féns 
rolling	ˈrəʊlɪŋ 	rəooling 
blues	bluːz 	blūz 
force	fɔːs 	fôs 
air	eə 	ã 
royal	ˈrɔɪəl 	rôēəl 
only	ˈəʊnli 	əoonlē 
told	təʊld 	təoold 
full	fʊl 	fool 
actually	ˈækʧʊəli 	akchüəlē 
night	naɪt 	nīt 
waiting	ˈweɪtɪŋ 	wāting 
pie	paɪ 	pī 
glad	glæd 	glad 
shut	ʃʌt 	shut 
feel	fiːl 	fēl 
again	əˈgɛn 	əgén 
supposed	səˈpəʊzd 	səpəoozd 
happening	ˈhæpnɪŋ 	hapning 
before	bɪˈfɔː 	bifô 
whoa	wəʊ 	wəoo 
expect	ɪksˈpɛkt 	ikspékt 
promised	ˈprɒmɪst 	promist 
met	mɛt 	mét 
went	wɛnt 	wént 
trust	trʌst 	trust 
sir	sɜː 	sû 
medal	ˈmɛdl 	médl 
ha	hɑː 	hä 
nothing	ˈnʌθɪŋ 	nuthing 
ground	graʊnd 	grownd 
feet	fiːt 	fēt 
ready	ˈrɛdi 	rédē 
rock	rɒk 	rok 
much	mʌʧ 	much 
i'd	aɪd 	īd 
mine	maɪn 	mīn 
had	hæd 	had 
father	ˈfɑːðə 	fäthə 
happen	ˈhæpən 	hapən 
circus	ˈsɜːkəs 	sûkəs 
even	ˈiːvən 	ēvən 
watch	wɒʧ 	woch 
world	wɜːld 	wûld 
any	ˈɛni 	énē 
knew	njuː 	nyü 
ranger	ˈreɪnʤə 	rānyə 
by	baɪ 	bī 
cause	kɔːz 	kôz 
america	əˈmɛrɪkə 	əmérikə 
close	kləʊs 	kləoos 
fixed	fɪkst 	fikst 
ouch	aʊʧ 	owch 
absolutely	ˈæbsəluːtli 	absəlūtlē 
giving	ˈgɪvɪŋ 	giving 
taken	ˈteɪkən 	tākən 
important	ɪmˈpɔːtənt 	impôtənt 
must	mʌst 	must 
poster	ˈpəʊstə 	pəoostə 
imagine	ɪˈmæʤɪn 	imayin 
open	ˈəʊpən 	əoopən 
hill	hɪl 	hil 
aren't	ɑːnt 	änt 
less	lɛs 	lés 
laying	ˈleɪɪŋ 	lāing 
wouldn't	ˈwʊdnt 	woodnt 
ooh	uː 	ū 
bought	bɔːt 	bôt 
wind	wɪnd 	wind 
hear	hɪə 	hēə 
escaping	ɪsˈkeɪpɪŋ 	iskāping 
finally	ˈfaɪnəli 	fīnəlē 
may	meɪ 	mā 
their	ðeə 	thã 
said	sɛd 	séd 
organized	ˈɔːgənaɪzd 	ôgənīzd 
after	ˈɑːftə 	äftə 
valuable	ˈvæljʊəbl 	valyüəbl 
feed	fiːd 	fēd 
than	ðæn 	than 
makes	meɪks 	māks 
fetcher	ˈfɛʧə 	féchə 
edwina	edwina 	edwēna 
ah	ɑː 	ä 
thought	θɔːt 	thôt 
new	njuː 	nyü 
dare	deə 	dã 
count	kaʊnt 	kownt 
called	kɔːld 	kôld 
discipline	ˈdɪsɪplɪn 	disiplin 
quick	kwɪk 	kwik 
you'll	juːl 	yül 
roll	rəʊl 	rəool 
yourself	jɔːˈsɛlf 	yôsélf 
nice	naɪs 	nīs 
morning	ˈmɔːnɪŋ 	môning 
tweedy's	tweedy's 	tweedy's 
fool	fuːl 	fūl 
gets	gɛts 	géts 
where'd	weəd 	wãd 
hatches	ˈhæʧɪz 	hachiz 
larry	ˈlæri 	larē 
happy	ˈhæpi 	hapē 
tooth	tuːθ 	tūth 
gold	gəʊld 	gəoold 
flashing	ˈflæʃɪŋ 	flashing 
chair	ʧeə 	chã 
rocking	ˈrɒkɪŋ 	roking 
gon'	gon' 	gon' 
yeow	yeow 	yeow 
er	eə 	ã 
paradise	ˈpærədaɪs 	parədīs 
fire	ˈfaɪə 	fīə 
pedal	ˈpɛdl 	pédl 
lower	ˈləʊə 	ləüə 
ramp	ræmp 	ramp 
cap'n	cap'n 	cap'n 
throttle	ˈθrɒtl 	throtl 
talking	ˈtɔːkɪŋ 	tôking 
behind	bɪˈhaɪnd 	bihīnd 
takeoff	takeoff 	takeoff 
wanderer	ˈwɒndərə 	wondərə 
town	taʊn 	town 
roger	ˈrəʊʤə 	rəooyə 
bum	bʌm 	bum 
ones	wʌnz 	wunz 
medals	ˈmɛdlz 	médlz 
squadron	ˈskwɒdrən 	skwodrən 
saving	ˈseɪvɪŋ 	sāving 
wanted	ˈwɒntɪd 	wontid 
stars	stɑːz 	stäz 
action	ˈækʃ(ə)n 	akshən 
lose	luːz 	lūz 
won't	wəʊnt 	wəoont 
hang	hæŋ 	hang 
hurry	ˈhʌri 	hurē 
jerry	ˈʤɛri 	yérē 
retaliation	rɪˌtælɪˈeɪʃən 	ritaliāshən 
panic	ˈpænɪk 	panik 
mustn't	ˈmʌsnt 	musnt 
blooming	ˈbluːmɪŋ 	blūming 
box	bɒks 	boks 
apple	ˈæpl 	apl 
idiot	ˈɪdɪət 	idēət 
machine	məˈʃiːn 	məshēn 
seems	siːmz 	sēmz 
attagirl	attagirl 	attagērl 
wine	waɪn 	wīn 
hits	hɪts 	hits 
till	tɪl 	til 
dance	dɑːns 	däns 
apparently	əˈpærəntli 	əparəntlē 
pulsing	ˈpʌlsɪŋ 	pulsing 
heavens	ˈhɛvnz 	hévnz 
ask	ɑːsk 	äsk 
here's	hɪəz 	hēəz 
working	ˈwɜːkɪŋ 	wûking 
truth	truːθ 	trūth 
funny	ˈfʌni 	funē 
rule	ruːl 	rūl 
hard-boiled	ˈhɑːdˈbɔɪld 	hädboēld 
save	seɪv 	sāv 
wrong	rɒŋ 	rong 
favorite	ˈfeɪvərɪt 	fāvərit 
food	fuːd 	fūd 
double	ˈdʌbl 	dubl 
certain	ˈsɜːtn 	sûtn 
lie	laɪ 	lī 
thieving	ˈθiːvɪŋ 	thēving 
guv	gʌv 	guv 
fish	fɪʃ 	fish 
seen	siːn 	sēn 
meself	meself 	meself 
sleep	sliːp 	slēp 
element	ˈɛlɪmənt 	élimənt 
calculations	ˌkælkjʊˈleɪʃənz 	kalkyoolāshənz 
quite	kwaɪt 	kwīt 
anyway	ˈɛnɪweɪ 	éniwā 
built	bɪlt 	bilt 
boxes	ˈbɒksɪz 	boksiz 
poor	pʊə 	püə 
mate	meɪt 	māt 
week	wiːk 	wēk 
worried	ˈwʌrid 	wurēd 
sound	saʊnd 	sownd 
doesn't	dʌznt 	duznt 
today	təˈdeɪ 	tədā 
four	fɔː 	fô 
agnes	ˈægnəs 	agnəs 
pain	peɪn 	pān 
birds	bɜːdz 	bûdz 
poultry	ˈpəʊltri 	pəooltrē 
careful	ˈkeəfʊl 	kãfool 
flipping	ˈflɪpɪŋ 	fliping 
obviously	ˈɒbvɪəsli 	obvēəslē 
gals	gælz 	galz 
flapping	ˈflæpɪŋ 	flaping 
perfect	ˈpɜːfɪkt 	pûfikt 
faster	ˈfɑːstə 	fästə 
circles	ˈsɜːklz 	sûklz 
means	miːnz 	mēnz 
twice	twaɪs 	twīs 
perseverance	ˌpɜːsɪˈvɪərəns 	pûsivēərəns 
takes	teɪks 	tāks 
either	ˈaɪðə 	īthə 
quarters	ˈkwɔːtəz 	kwôtəz 
outrageous	aʊtˈreɪʤəs 	owtrāyəs 
room	ruːm 	rūm 
comfortable	ˈkʌmfətəbl 	kumfətəbl 
fancy	ˈfænsi 	fansē 
sister	ˈsɪstə 	sistə 
decided	dɪˈsaɪdɪd 	disīdid 
chick	ʧɪk 	chik 
kind	kaɪnd 	kīnd 
run	rʌn 	run 
likes	laɪks 	līks 
guy	gaɪ 	gī 
type	taɪp 	tīp 
leaving	ˈliːvɪŋ 	lēving 
agree	əˈgriː 	əgrē 
pull	pʊl 	pool 
own	əʊn 	əoon 
part	pɑːt 	pät 
cruel	krʊəl 	krüəl 
possible	ˈpɒsəbl 	posəbl 
point	pɔɪnt 	poēnt 
yep	jɛp 	yép 
road	rəʊd 	rəood 
couldn't	ˈkʊdnt 	koodnt 
whole	həʊl 	həool 
chicks	ʧɪks 	chiks 
red	rɛd 	réd 
mister	ˈmɪstə 	mistə 
mind	maɪnd 	mīnd 
eating	ˈiːtɪŋ 	ēting 
brave	breɪv 	brāv 
home	həʊm 	həoom 
eyes	aɪz 	īz 
i-i	aɪ-aɪ 	ī-ī 
made	meɪd 	mād 
english	ˈɪŋglɪʃ 	ingglish 
wrapped	ræpt 	rapt 
sprained	spreɪnd 	sprānd 
rather	ˈrɑːðə 	räthə 
gotta	ˈgɒtə 	gotə 
dark	dɑːk 	däk 
rooster	ˈruːstə 	rūstə 
professional	prəˈfɛʃənl 	prəféshənl 
quickly	ˈkwɪkli 	kwiklē 
you've	juːv 	yüv 
heaven	ˈhɛvn 	hévn 
chance	ʧɑːns 	chäns 
ducks	dʌks 	duks 
fantastic	fænˈtæstɪk 	fantastik 
such	sʌʧ 	such 
farmers	ˈfɑːməz 	fäməz 
farmer	ˈfɑːmə 	fämə 
where's	weəz 	wãz 
ourselves	ˌaʊəˈsɛlvz 	owəsélvz 
fences	ˈfɛnsɪz 	fénsiz 
empty	ˈɛmpti 	émptē 
yet	jɛt 	yét 
farmer's	ˈfɑːməz 	fäməz 
em	ɛm 	ém 
escape	ɪsˈkeɪp 	iskāp 
ranks	ræŋks 	rangks 
settle	ˈsɛtl 	sétl 
clear	klɪə 	klēə 
ridiculous	rɪˈdɪkjʊləs 	ridikyooləs 
found	faʊnd 	fownd 
profits	ˈprɒfɪts 	profits 
minuscule	ˈmɪnəskjuːl 	minəskyül 
creatures	ˈkriːʧəz 	krēchəz 
worthless	ˈwɜːθlɪs 	wûthlis 
d-oh	diː-əʊ 	dē-əoo 
times	taɪmz 	tīmz 
nine	naɪn 	nīn 
pay	peɪ 	pā 
others	ˈʌðəz 	uthəz 
job	ʤɒb 	yob 
big	bɪg 	big 
voila	voila 	voēla 
french	frɛnʧ 	frénch 
coops	kuːps 	kūps 
beautiful	ˈbjuːtəfʊl 	byütəfool 
lovely	ˈlʌvli 	luvlē 
set	sɛt 	sét 
hut	hʌt 	hut 
tonight	təˈnaɪt 	tənīt 
yours	jɔːz 	yôz 
five	faɪv 	fīv 
laid	leɪd 	lād 
how's	haʊz 	howz 
welcome	ˈwɛlkəm 	wélkəm 
attention	əˈtɛnʃ(ə)n 	əténshən 
senior	ˈsiːnjə 	sēnyə 
you'd	juːd 	yüd 
scramble	ˈskræmbl 	skrambl 
pip	pɪp 	pip 
late	leɪt 	lāt 
stuck	stʌk 	stuk 
credit	ˈkrɛdɪt 	krédit 
ard	ard 	ard 
rats	ræts 	rats 
folk	fəʊk 	fəook 
biz	bɪz 	biz 
shot	ʃɒt 	shot 
thinks	θɪŋks 	thingks 
pillock	pillock 	pēllock 
gitface	gitface 	gētface 
thanks	θæŋks 	thangks 
pardon	ˈpɑːdn 	pädn 
beg	bɛg 	bég 
enjoy	ɪnˈʤɔɪ 	inyoē 
listening	ˈlɪsnɪŋ 	lisning 
mentioned	ˈmɛnʃənd 	ménshənd 
lays	leɪz 	lāz 
hatch	hæʧ 	hach 
conversely	ˈkɒnvɜːsli 	konvûslē 
where'dit	where'dit 	where'dēt 
wondering	ˈwʌndərɪŋ 	wundəring 
crack	kræk 	krak 
ha-ha	hɑːˈhɑː 	hähä 
booth	buːð 	būth 
phone	fəʊn 	fəoon 
rumba	ˈrʌmbə 	rumbə 
small	smɔːl 	smôl 
ohh	ohh 	ohh 
overtake	ˌəʊvəˈteɪk 	əoovətāk 
cobblers	ˈkɒbləz 	kobləz 
eat	iːt 	ēt 
cricket	ˈkrɪkɪt 	krikit 
play	pleɪ 	plā 
imagined	ɪˈmæʤɪnd 	imayind 
imperative	ɪmˈpɛrətɪv 	impérətiv 
safety	ˈseɪfti 	sāftē 
sad	sæd 	sad 
prang	præŋ 	prang 
fearful	ˈfɪəfʊl 	fēəfool 
heading	ˈhɛdɪŋ 	héding 
altitude	ˈæltɪtjuːd 	altityüd 
losing	ˈluːzɪŋ 	lūzing 
drumsticks	ˈdrʌmstɪks 	drumstiks 
pedaling	ˈpɛdlɪŋ 	pédling 
twee	twee 	twee 
bird	bɜːd 	bûd 
bombs	bɒmz 	bomz 
ammo	ˈæməʊ 	aməoo 
giblets	ˈʤɪblɪts 	yiblits 
velocity	vɪˈlɒsɪti 	vilositē 
increase	ˈɪnkriːs 	inkrēs 
bingo	ˈbɪŋgəʊ 	binggəoo 
scissors	ˈsɪzəz 	sizəz 
goodness	ˈgʊdnɪs 	goodnis 
engines	ˈɛnʤɪnz 	ényinz 
cling-on	klɪŋ-ɒn 	kling-on 
scott	skɒt 	skot 
runway	ˈrʌnweɪ 	runwā 
mother	ˈmʌðə 	muthə 
gotcha	ˈgɒʧə 	gochə 
miracles	ˈmɪrəklz 	mirəklz 
cannot	ˈkænɒt 	kanot 
power	ˈpaʊə 	powə 
cleared	klɪəd 	klēəd 
contact	ˈkɒntækt 	kontakt 
duty	ˈdjuːti 	dyütē 
reporting	rɪˈpɔːtɪŋ 	ripôting 
t	tiː 	tē 
commander	kəˈmɑːndə 	kəmändə 
sausage	ˈsɒsɪʤ 	sosiy 
aircraft	ˈeəkrɑːft 	ãkräft 
complex	ˈkɒmplɛks 	kompléks 
controls	kənˈtrəʊlz 	kəntrəoolz 
plane	pleɪn 	plān 
mascots	ˈmæskəts 	maskəts 
division	dɪˈvɪʒən 	divizhən 
contraption	kənˈtræpʃən 	kəntrapshən 
pilot	ˈpaɪlət 	pīlət 
knees	niːz 	nēz 
between	bɪˈtwiːn 	bitwēn 
emergency	ɪˈmɜːʤənsi 	imûyənsē 
event	ɪˈvɛnt 	ivént 
likely	ˈlaɪkli 	līklē 
located	ləʊˈkeɪtɪd 	ləookātid 
exits	ˈɛksɪts 	éksits 
choices	ˈʧɔɪsɪz 	choēsiz 
revolting	rɪˈvəʊltɪŋ 	rivəoolting 
aaaah	aaaah 	aaaah 
attack	əˈtæk 	ətak 
buggers	ˈbʌgəz 	bugəz 
tools	tuːlz 	tūlz 
boy	bɔɪ 	boē 
travel	ˈtrævl 	travl 
car	kɑː 	kä 
girl	gɜːl 	gûl 
falling	ˈfɔːlɪŋ 	fôling 
myself	maɪˈsɛlf 	mīsélf 
hand	hænd 	hand 
secure	sɪˈkjʊə 	sikyüə 
gnomes	ˈnəʊmiːz 	nəoomēz 
dickens	ˈdɪkɪnz 	dikinz 
advance	ədˈvɑːns 	ədväns 
payment	ˈpeɪmənt 	pāmənt 
list	lɪst 	list 
item	ˈaɪtəm 	ītəm 
mum	mʌm 	mum 
lady	ˈleɪdi 	lādē 
roosters	ˈruːstəz 	rūstəz 
advisor	ədˈvaɪzə 	ədvīzə 
aviation	ˌeɪvɪˈeɪʃ(ə)n 	āviāshən 
chief	ʧiːf 	chēf 
manufacturing	ˌmænjʊˈfækʧərɪŋ 	manyoofakchəring 
engineering	ˌɛnʤɪˈnɪərɪŋ 	ényinēəring 
handle	ˈhændl 	handl 
provided	prəˈvaɪdɪd 	prəvīdid 
fowler's	ˈfaʊləz 	fowləz 
able	ˈeɪbl 	ābl 
duffed	dʌft 	duft 
weather	ˈwɛðə 	wéthə 
go-ahead	ˈgəʊəhɛd 	gəüəhéd 
given	ˈgɪvn 	givn 
ops	ops	ops
recce	recce 	recce 
story	ˈstɔːri 	stôrē 
beautifully	ˈbjuːtəfʊli 	byütəfoolē 
gorgeous	ˈgɔːʤəs 	gôyəs 
ahh	ahh 	ahh 
offer	ˈɒfə 	ofə 
a-as	ə-æz 	ə-az 
forgive	fəˈgɪv 	fəgiv 
madam	ˈmædəm 	madəm 
wizard	ˈwɪzəd 	wizəd 
co	kəʊ 	kəoo 
charlie	ˈʧɑːli 	chälē 
tail-end	ˈteɪlˈɛnd 	tālénd 
whizzbang	ˈwɪzbæŋ 	wizbang 
map	mæp 	map 
flappy	flappy 	flappy 
stick	stɪk 	stik 
jocko	ˈʤɒkəʊ 	yokəoo 
proper	ˈprɒpə 	propə 
conquer	ˈkɒŋkə 	kongkə 
divide	dɪˈvaɪd 	divīd 
precisely	prɪˈsaɪsli 	prisīslē 
dissension	dɪˈsɛnʃən 	disénshən 
four-eyes	fɔːr-aɪz 	fôr-īz 
push	pʊʃ 	poosh 
hitting	ˈhɪtɪŋ 	hiting 
knitting	ˈnɪtɪŋ 	niting 
infernal	ɪnˈfɜːnl 	infûnl 
pastry	ˈpeɪstri 	pāstrē 
next	nɛkst 	nékst 
american	əˈmɛrɪkən 	əmérikən 
fake	feɪk 	fāk 
cannon	ˈkænən 	kanən 
r-rocky	ɑː-ˈrɒki 	ä-rokē 
everyone's	ˈɛvrɪwʌnz 	évriwunz 
knock-knock	nɒk-nɒk 	nok-nok 
warming	ˈwɔːmɪŋ 	wôming 
girls	gɜːlz 	gûlz 
today's	təˈdeɪz 	tədāz 
company	ˈkʌmpəni 	kumpənē 
closer	ˈkləʊsə 	kləoosə 
looking	ˈlʊkɪŋ 	looking 
prickly	ˈprɪkli 	priklē 
brown	braʊn 	brown 
greener	ˈgriːnə 	grēnə 
cracked	krækt 	krakt 
disappointments	ˌdɪsəˈpɔɪntmənts 	disəpoēntmənts 
stuff	stʌf 	stuf 
ranging	ˈreɪnʤɪŋ 	rānying 
experienced	ɪksˈpɪərɪənst 	ikspēərēənst 
y-you	waɪ-juː 	wī-yü 
hills	hɪlz 	hilz 
rambling	ˈræmblɪŋ 	rambling 
beneath	bɪˈniːθ 	binēth 
felt	fɛlt 	félt 
lives	lɪvz 	livz 
harsh	hɑːʃ 	häsh 
ahead	əˈhɛd 	əhéd 
since	sɪns 	sins 
both	bəʊθ 	bəooth 
anticipation	ænˌtɪsɪˈpeɪʃ(ə)n 	antisipāshən 
demonstration	ˌdɛmənsˈtreɪʃən 	démənstrāshən 
tomorrow's	təˈmɒrəʊz 	təmorəooz 
await	əˈweɪt 	əwāt 
entirely	ɪnˈtaɪəli 	intīəlē 
surrender	səˈrɛndə 	səréndə 
occasion	əˈkeɪʒən 	əkāzhən 
honor	ˈɒnə 	onə 
salute	səˈluːt 	səlūt 
bravery	ˈbreɪvəri 	brāvərē 
present	ˈprɛznt 	préznt 
character	ˈkærɪktə 	kariktə 
misjudged	ˌmɪsˈʤʌʤd 	misyuyd 
admit	ədˈmɪt 	ədmit 
dutifully	ˈdjuːtɪfʊli 	dyütifoolē 
evening	ˈiːvnɪŋ 	ēvning 
light	laɪt 	līt 
deed	diːd 	dēd 
honorable	ˈɒnərəbl 	onərəbl 
smoother	ˈsmuːðə 	smūthə 
everything's	ˈɛvrɪθɪŋz 	évrithingz 
once	wʌns 	wuns 
sabotaged	ˈsæbətɑːʒd 	sabətäzhd 
meant	mɛnt 	mént 
gravy	ˈgreɪvi 	grāvē 
owt	owt 	owt 
pudding	ˈpʊdɪŋ 	pooding 
blow	bləʊ 	bləoo 
door	dɔː 	dô 
com	kɒm 	kom 
oven	ˈʌvn 	uvn 
oops	uːps 	ūps 
dough	dəʊ 	dəoo 
vegetables	ˈvɛʤɪtəblz 	véyitəblz 
mixed	mɪkst 	mikst 
shoot	ʃuːt 	shūt 
yo	jəʊ 	yəoo 
brilliant	ˈbrɪljənt 	brilyənt 
size	saɪz 	sīz 
boost	buːst 	būst 
trousers	ˈtraʊzəz 	trowzəz 
catch	kæʧ 	kach 
surprise	səˈpraɪz 	səprīz 
they'd	ðeɪd 	thād 
laddie	ˈlædi 	ladē 
chops	ʧɒps 	chops 
taking	ˈteɪkɪŋ 	tāking 
calls	kɔːlz 	kôlz 
prisoner	ˈprɪznə 	priznə 
enemy	ˈɛnɪmi 	énimē 
they've	ðeɪv 	thāv 
heck	hɛk 	hék 
score	skɔː 	skô 
public	ˈpʌblɪk 	publik 
touch	tʌʧ 	tuch 
woman's	ˈwʊmənz 	woomənz 
missus	ˈmɪsɪz 	misiz 
homemade	ˈhəʊmˈmeɪd 	həoommād 
upon	əˈpɒn 	əpon 
stocked	stɒkt 	stokt 
county	ˈkaʊnti 	kowntē 
grocers'	ˈgrəʊsəz 	grəoosəz 
fortnight	ˈfɔːtnaɪt 	fôtnīt 
lummox	ˈlʌməks 	luməks 
champion	ˈʧæmpjən 	champyən 
soft	sɒft 	soft 
turning	ˈtɜːnɪŋ 	tûning 
cared	keəd 	kãd 
apology	əˈpɒləʤi 	əpoləyē 
owe	əʊ 	əoo 
looks	lʊks 	looks 
babsy	babsy 	babsy 
worthwhile	ˈwɜːθˈwaɪl 	wûthwīl 
moments	ˈməʊmənts 	məoomənts 
nancy	ˈnænsi 	nansē 
sobbing	ˈsɒbɪŋ 	sobing 
authorizing	ˈɔːθəraɪzɪŋ 	ôthərīzing 
recall	rɪˈkɔːl 	rikôl 
gal	gæl 	gal 
flow	fləʊ 	fləoo 
body	ˈbɒdi 	bodē 
through	θruː 	thrū 
beat	biːt 	bēt 
nellypodging	nellypodging 	nellypodgēng 
feathers	ˈfɛðəz 	féthəz 
tail	teɪl 	tāl 
shake	ʃeɪk 	shāk 
kick	kɪk 	kik 
yolker	ˈjəʊkə 	yəookə 
solid	ˈsɒlɪd 	solid 
craftsmanship	ˈkrɑːftsmənʃɪp 	kräftsmənship 
biblical	ˈbɪblɪkəl 	biblikəl 
receive	rɪˈsiːv 	risēv 
assure	əˈʃʊə 	əshüə 
hope	həʊp 	həoop 
anything	ˈɛnɪθɪŋ 	énithing 
happens	ˈhæpənz 	hapənz 
honest	ˈɒnɪst 	onist 
difficult	ˈdɪfɪkəlt 	difikəlt 
perform	pəˈfɔːm 	pəfôm 
advice	ədˈvaɪs 	ədvīs 
hasn't	ˈhæznt 	haznt 
charm	ʧɑːm 	chäm 
death	dɛθ 	déth 
mention	ˈmɛnʃən 	ménshən 
someone	ˈsʌmwʌn 	sumwun 
motivate	ˈməʊtɪveɪt 	məootivāt 
lighten	ˈlaɪtn 	lītn 
minutes	ˈmɪnɪts 	minits 
alert	əˈlɜːt 	əlût 
heavy	ˈhɛvi 	hévē 
fattening	ˈfætnɪŋ 	fatning 
extra	ˈɛkstrə 	ékstrə 
chop	ʧɒp 	chop 
stops	stɒps 	stops 
barn	bɑːn 	bän 
arrive	əˈraɪv 	ərīv 
strange	streɪnʤ 	strāny 
boring	ˈbɔːrɪŋ 	bôring 
flashed	flæʃt 	flasht 
fat	fæt 	fat 
rations	ˈræʃənz 	rashənz 
busy	ˈbɪzi 	bizē 
offense	əˈfɛns 	əféns 
release	rɪˈliːs 	rilēs 
killing	ˈkɪlɪŋ 	kiling 
tension's	ˈtɛnʃənz 	ténshənz 
exercise	ˈɛksəsaɪz 	éksəsīz 
helper	ˈhɛlpə 	hélpə 
sweetheart	ˈswiːthɑːt 	swēthät 
thrrrust	thrrrust 	thrrrūst 
truths	truːðz 	trūthz 
omitted	əˈmɪtɪd 	əmitid 
lied	laɪd 	līd 
sucker	ˈsʌkə 	sukə 
business	ˈbɪznɪs 	biznis 
pleasure	ˈplɛʒə 	plézhə 
posted	ˈpəʊstɪd 	pəoostid 
speak	spiːk 	spēk 
brewing	ˈbruːɪŋ 	brūing 
installment	ɪnˈstɔːlmənt 	instôlmənt 
month	mʌnθ 	munth 
bright	braɪt 	brīt 
gone	gɒn 	gon 
parasites	ˈpærəsaɪts 	parəsīts 
light-fingered	ˈlaɪtˌfɪŋgəd 	lītfinggəd 
sneakiest	ˈsniːkɪɪst 	snēkiist 
doubt	daʊt 	dowt 
each	iːʧ 	ēch 
crooks	krʊks 	krooks 
spanish	ˈspænɪʃ 	spanish 
merchandiso	merchandiso 	merchandēso 
el	ɛl 	él 
norbert	norbert 	norbert 
slipped	slɪpt 	slipt 
wish	wɪʃ 	wish 
piece	piːs 	pēs 
guv'nor	guv'nor 	gūv'nor 
beaut	beaut 	beaūt 
cock-a-doodle-doo	kɒk-ə-ˈduːdl-doo 	kok-ə-dūdl-doo 
case	keɪs 	kās 
rock's	rɒks 	roks 
angel	ˈeɪnʤəl 	ānyəl 
tight	taɪt 	tīt 
shell	ʃɛl 	shél 
flyboy	flyboy 	flyboy 
find	faɪnd 	fīnd 
hiding	ˈhaɪdɪŋ 	hīding 
results	rɪˈzʌlts 	rizults 
excuse	ɪksˈkjuːs 	ikskyüs 
words	wɜːdz 	wûdz 
using	ˈjuːzɪŋ 	yüzing 
swear	sweə 	swã 
geese	giːs 	gēs 
key	kiː 	kē 
figured	ˈfɪgəd 	figəd 
lifted	ˈlɪftɪd 	liftid 
running	ˈrʌnɪŋ 	runing 
rapidly	ˈræpɪdli 	rapidlē 
compare	kəmˈpeə 	kəmpã 
gifted	ˈgɪftɪd 	giftid 
oranges	ˈɒrɪnʤɪz 	orinyiz 
apples	ˈæplz 	aplz 
learn	lɜːn 	lûn 
flown	fləʊn 	fləoon 
punch	pʌnʧ 	punch 
packs	pæks 	paks 
cutest	ˈkjuːtɪst 	kyütist 
warmer	ˈwɔːmə 	wômə 
beak	biːk 	bēk 
swell	swɛl 	swél 
thoughts	θɔːts 	thôts 
flighty	ˈflaɪti 	flītē 
thinking	ˈθɪŋkɪŋ 	thingking 
tips	tɪps 	tips 
remember	rɪˈmɛmbə 	rimémbə 
cocktail	ˈkɒkteɪl 	koktāl 
fella	ˈfɛlə 	félə 
horse	hɔːs 	hôs 
says	sɛz 	séz 
pig	pɪg 	pig 
ticket	ˈtɪkɪt 	tikit 
trusted	ˈtrʌstɪd 	trustid 
young	jʌŋ 	yung 
beware	bɪˈweə 	biwã 
suffice	səˈfaɪs 	səfīs 
simple	ˈsɪmpl 	simpl 
nanny	ˈnæni 	nanē 
being	ˈbiːɪŋ 	bēing 
nowhere	ˈnəʊweə 	nəoowã 
questions	ˈkwɛsʧənz 	kwéschənz 
believe	bɪˈliːv 	bilēv 
saw	sɔː 	sô 
calculating	ˈkælkjʊleɪtɪŋ 	kalkyoolāting 
doom	duːm 	dūm 
voice	vɔɪs 	voēs 
hate	heɪt 	hāt 
hay	heɪ 	hā 
softer	ˈsɒftə 	softə 
whatever's	wɒtˈɛvəz 	wotévəz 
longer	ˈlɒŋgə 	longgə 
melisha	melisha 	melēsha 
production	prəˈdʌkʃən 	prədukshən 
automated	ˈɔːtəmeɪtɪd 	ôtəmātid 
full-scale	ˈfʊlˈskeɪl 	foolskāl 
ages	ˈeɪʤɪz 	āyiz 
change	ʧeɪnʤ 	chāny 
nothings	ˈnʌθɪŋz 	nuthingz 
fathers	ˈfɑːðəz 	fäthəz 
collection	kəˈlɛkʃən 	kəlékshən 
petty	ˈpɛti 	pétē 
wasting	ˈweɪstɪŋ 	wāsting 
future	ˈfjuːʧə 	fyüchə 
cheers	ʧɪəz 	chēəz 
within	wɪˈðɪn 	within 
charge	ʧɑːʤ 	chäy 
rest	rɛst 	rést 
immediately	ɪˈmiːdjətli 	imēdyətlē 
officer's	ˈɒfɪsəz 	ofisəz 
lunatic	ˈluːnətɪk 	lūnətik 
awarded	əˈwɔːdɪd 	əwôdid 
shaking	ˈʃeɪkɪŋ 	shāking 
ground's	graʊndz 	growndz 
cheese-eating	ʧiːz-ˈiːtɪŋ 	chēz-ēting 
process	ˈprəʊsɛs 	prəoosés 
roof	ruːf 	rūf 
ducky	ˈdʌki 	dukē 
faith	feɪθ 	fāth 
positive	ˈpɒzətɪv 	pozətiv 
friend	frɛnd 	frénd 
feather	ˈfɛðə 	féthə 
motion	ˈməʊʃən 	məooshən 
scrambled	ˈskræmbld 	skrambld 
definitely	ˈdɛfɪnɪtli 	définitlē 
sunny-side	ˈsʌni-saɪd 	sunē-sīd 
themselves	ðəmˈsɛlvz 	thəmsélvz 
fetch	fɛʧ 	féch 
hell	hɛl 	hél 
caper	ˈkeɪpə 	kāpə 
raining	ˈreɪnɪŋ 	rāning 
senses	ˈsɛnsɪz 	sénsiz 
attila	attila 	attēla 
anymore	ˌɛniˈmɔː 	énēmô 
walk	wɔːk 	wôk 
certainly	ˈsɜːtnli 	sûtnlē 
dizzy	ˈdɪzi 	dizē 
cut	kʌt 	kut 
progress	ˈprəʊgrəs 	prəoogrəs 
relax	rɪˈlæks 	rilaks 
involved	ɪnˈvɒlvd 	involvd 
usually	ˈjuːʒʊəli 	yüzhüəlē 
spot	spɒt 	spot 
pecking	ˈpɛkɪŋ 	péking 
team	tiːm 	tēm 
codswallop	codswallop 	codswallop 
overnight	ˌəʊvəˈnaɪt 	əoovənīt 
huh	hʌ 	hu 
breath	brɛθ 	bréth 
smell	smɛl 	smél 
wing's	wɪŋz 	wingz 
scoot	skuːt 	skūt 
choice	ʧɔɪs 	choēs 
weren't	wɜːnt 	wûnt 
noncommissioned	noncommissioned 	noncommēssēoned 
share	ʃeə 	shã 
asking	ˈɑːskɪŋ 	äsking 
end	ɛnd 	énd 
held	hɛld 	héld 
hideout	ˈhaɪdˈaʊt 	hīdowt 
maybe	ˈmeɪbiː 	mābē 
vulture	ˈvʌlʧə 	vulchə 
freedom	ˈfriːdəm 	frēdəm 
emphasis	ˈɛmfəsɪs 	émfəsis 
torch	tɔːʧ 	tôch 
sure	ʃʊə 	shüə 
finds	faɪndz 	fīndz 
what'll	ˈwɒt(ə)l 	wotəl 
crazy	ˈkreɪzi 	krāzē 
cute	kjuːt 	kyüt 
shouldn't	ʃʊdnt 	shoodnt 
reason	ˈriːzn 	rēzn 
should	ʃʊd 	shood 
low	ləʊ 	ləoo 
suicide	ˈsjʊɪsaɪd 	syooisīd 
stunt	stʌnt 	stunt 
certifiable	ˈsɜːtɪfaɪəbl 	sûtifīəbl 
straight	streɪt 	strāt 
minute	ˈmɪnɪt 	minit 
bust	bʌst 	bust 
birdcage	ˈbɜːdkeɪʤ 	bûdkāy 
besides	bɪˈsaɪdz 	bisīdz 
problems	ˈprɒbləmz 	probləmz 
understand	ˌʌndəˈstænd 	undəstand 
used	juːzd 	yüzd 
properly	ˈprɒpəli 	propəlē 
situation	ˌsɪtjʊˈeɪʃən 	sityooāshən 
explain	ɪksˈpleɪn 	iksplān 
exit	ˈɛksɪt 	éksit 
hearing	ˈhɪərɪŋ 	hēəring 
born	bɔːn 	bôn 
calling	ˈkɔːlɪŋ 	kôling 
shh	shh 	shh 
amen	ˈɑːˈmɛn 	ämén 
blows	bləʊz 	bləooz 
pack	pæk 	pak 
style	staɪl 	stīl 
nope	nəʊp 	nəoop 
hi	haɪ 	hī 
barnyard	ˈbɑːnˌjɑːd 	bänyäd 
nature	ˈneɪʧə 	nāchə 
traveler	ˈtrævlə 	travlə 
england	ˈɪŋglənd 	ingglənd 
brings	brɪŋz 	bringz 
miracle	ˈmɪrəkl 	mirəkl 
prayers	preəz 	prãz 
desperate	ˈdɛspərɪt 	déspərit 
group	gruːp 	grūp 
wants	wɒnts 	wonts 
catchy	ˈkæʧi 	kachē 
short	ʃɔːt 	shôt 
island	ˈaɪlənd 	īlənd 
rhode	ˈrəʊd 	rəood 
name's	neɪmz 	nāmz 
grandpa	ˈgrænpɑː 	granpä 
oversexed	ˌəʊvəˈsɛkst 	əoovəsékst 
overpaid	ˌəʊvəˈpeɪd 	əoovəpād 
war	wɔː 	wô 
showing	ˈʃəʊɪŋ 	shəooing 
americans	əˈmɛrɪkənz 	əmérikənz 
pushy	ˈpʊʃi 	pooshē 
poppycock	ˈpɒpɪkɒk 	popikok 
scotland	ˈskɒtlənd 	skotlənd 
land	lænd 	land 
illegal	ɪˈliːgəl 	ilēgəl 
cockfighting's	ˈkɒkˌfaɪtɪŋz 	kokfītingz 
far	fɑː 	fä 
excit	excit 	excēt 
rude	ruːd 	rūd 
top	tɒp 	top 
carried	ˈkærid 	karēd 
bandage	ˈbændɪʤ 	bandiy 
tweak	twiːk 	twēk 
wee	wiː 	wē 
gave	geɪv 	gāv 
tendon	ˈtɛndən 	téndən 
anterior	ænˈtɪərɪə 	antēərēə 
fall	fɔːl 	fôl 
nasty	ˈnɑːsti 	nästē 
took	tʊk 	took 
happened	ˈhæpənd 	hapənd 
suppose	səˈpəʊz 	səpəooz 
demonstrations	ˌdɛmənsˈtreɪʃənz 	démənstrāshənz 
flies	flaɪz 	flīz 
obvious	ˈɒbvɪəs 	obvēəs 
picture	ˈpɪkʧə 	pikchə 
posters	ˈpəʊstəz 	pəoostəz 
inside	ɪnˈsaɪd 	insīd 
audience	ˈɔːdjəns 	ôdyəns 
wonderful	ˈwʌndəfʊl 	wundəfool 
gentlemen	ˈʤɛnt(ə)lmən 	yéntəlmən 
freedoooom	freedoooom 	freedoooom 
bunch	bʌnʧ 	bunch 
lead	liːd 	lēd 
million	ˈmɪljən 	milyən 
chances	ˈʧɑːnsɪz 	chänsiz 
facts	fækts 	fakts 
tripe	traɪp 	trīp 
load	ləʊd 	ləood 
heard	hɜːd 	hûd 
keys	kiːz 	kēz 
dogs	dɒgz 	dogz 
anywhere	ˈɛnɪweə 	éniwã 
live	lɪv 	liv 
feeds	fiːdz 	fēdz 
green	griːn 	grēn 
cool	kuːl 	kūl 
trees	triːz 	trēz 
lots	lɒts 	lots 
spaces	ˈspeɪsɪz 	spāsiz 
wide	waɪd 	wīd 
beyond	bɪˈjɒnd 	biyond 
somewhere	ˈsʌmweə 	sumwã 
living	ˈlɪvɪŋ 	living 
enough	ɪˈnʌf 	inuf 
roasted	ˈrəʊstɪd 	rəoostid 
stuffed	stʌft 	stuft 
plucked	plʌkt 	plukt 
spent	spɛnt 	spént 
she'd	ʃiːd 	shēd 
nests	nɛsts 	nésts 
many	ˈmɛni 	ménē 
hmm	hmm 	hmm 
cover-up	ˈkʌvərˈʌp 	kuvərup 
operation	ˌɒpəˈreɪʃən 	opərāshən 
turnip's	ˈtɜːnɪps 	tûnips 
grief	griːf 	grēf 
wire	ˈwaɪə 	wīə 
brand-new	ˈbrændˈnjuː 	brandnyü 
fiasco	fɪˈæskəʊ 	fiaskəoo 
attempt	əˈtɛmpt 	ətémpt 
last	lɑːst 	läst 
carry	ˈkæri 	karē 
chit-chat	ˈʧɪtʧæt 	chitchat 
unnecessary	ʌnˈnɛsɪsəri 	unnésisərē 
waste	weɪst 	wāst 
allowed	əˈlaʊd 	əlowd 
scheme	skiːm 	skēm 
plot	plɒt 	plot 
planet	ˈplænɪt 	planit 
apart	əˈpɑːt 	əpät 
dolt	dəʊlt 	dəoolt 
another	əˈnʌðə 	ənuthə 
telling	ˈtɛlɪŋ 	téling 
notions	ˈnəʊʃənz 	nəooshənz 
money	ˈmʌni 	munē 
leader	ˈliːdə 	lēdə 
reckon	ˈrɛkən 	rékən 
onto	ˈɒntʊ 	ontoo 
tired	ˈtaɪəd 	tīəd 
sick	sɪk 	sik 
ha'penny	ha'penny 	ha'penny 
fourpence	fourpence 	foūrpence 
sixpence	ˈsɪkspəns 	sikspəns 
seven	ˈsɛvn 	sévn 
threepence	ˈθrɛpəns 	thrépəns 
shillings	ˈʃɪlɪŋz 	shilingz 
fourteen	ˈfɔːˈtiːn 	fôtēn 
twenty-two	ˈtwɛnti-tuː 	twéntē-tū 
move	muːv 	mūv 
else	ɛls 	éls 
seed	siːd 	sēd 
bag	bæg 	bag 
cost	kɒst 	kost 
bigger	ˈbɪgə 	bigə 
duck	dʌk 	duk 
dream	driːm 	drēm 
vision	ˈvɪʒən 	vizhən 
madame	ˈmædəm 	madəm 
weddings	ˈwɛdɪŋz 	wédingz 
parties	ˈpɑːtiz 	pätēz 
hats	hæts 	hats 
hens	hɛnz 	hénz 
pop	pɒp 	pop 
simply	ˈsɪmpli 	simplē 
paree	paree 	paree 
fashionable	ˈfæʃnəbl 	fashnəbl 
rage	reɪʤ 	rāy 
number	ˈnʌmbə 	numbə 
pendant	ˈpɛndənt 	péndənt 
necklace	ˈnɛklɪs 	néklis 
tea	tiː 	tē 
handcrafted	handcrafted 	handcrafted 
quality	ˈkwɒlɪti 	kwolitē 
service	ˈsɜːvɪs 	sûvis 
nick	nɪk 	nik 
meeting	ˈmiːtɪŋ 	mēting 
spread	sprɛd 	spréd 
anyone	ˈɛnɪwʌn 	éniwun 
well-chuffed	wɛl-ʧʌft 	wél-chuft 
grounded	ˈgraʊndɪd 	growndid 
lad	læd 	lad 
reprimand	ˈrɛprɪmɑːnd 	réprimänd 
stern	stɜːn 	stûn 
ranking	ˈræŋkɪŋ 	rangking 
talk	tɔːk 	tôk 
tally-ho	ˈtælɪˈhəʊ 	talihəoo 
smarten	ˈsmɑːtn 	smätn 
march	mɑːʧ 	mäch 
parade	pəˈreɪd 	pərād 
confinement	kənˈfaɪnmənt 	kənfīnmənt 
solitary	ˈsɒlɪtəri 	solitərē 
wasn't	wɒznt 	woznt 
escapes	ɪsˈkeɪps 	iskāps 
lot	lɒt 	lot 
lesson	ˈlɛsn 	lésn 
outside	ˌaʊtˈsaɪd	owtsīd
