- 和所有	- and all
- 成為	- to-be
- 流行音樂	- a pop
- 請講	- speaking
- 那是	- that was
一下子	in a snap
一些大小	of some size
一些希望	some hope
一些東西	something of
一件事	a matter of
一件事	for one thing
一件事和另一件事	one thing and another
一件事導致另一件事	one thing leads to another
一份好工作	a good job
一例	case in point
一個	for one
一個glut子的懲罰	a glutton for punishment
一個下去	go off on one
一個乾淨的健康賬單	a clean bill of health
一個事實的生活	a fact of life
一個人住在哪裡	where one lives
一個人的喜好	for one's liking
一個人的堅果	off one's nut
一個人的時間	bide one's time
一個人的背部轉身	one's back is turned
一個信仰的文章	an article of faith
一個傻瓜和他的錢很快就分手了	a fool and his money are soon parted
一個僵硬的上唇	a stiff upper lip
一個公平的競爭環境	a level playing field
一個切割上面	a cut above
一個原始的交易	a raw deal
一個和所有	one and all
一個國家	one nation
一個國王的贖金	a king's ransom
一個圓形孔的方形釘	a square peg in a round hole
一個在陽光下的地方	a place in the sun
一個垂死的品種	a dying breed
一個堅硬的堅果破解	a hard nut to crack
一個堅韌的堅果破解	a tough nut to crack
一個大黃蜂巢	a hornets' nest
一個好話	a good word
一個好轉應該是另一回事	one good turn deserves another
一個字給智者	a word to the wise
一個完成的交易	a done deal
一個小事	a trifle
一個小財富	a small fortune
一個巴掌拍不響	it takes two to tango
一個幫手	a helping hand
一個很好的小收入	a nice little earner
一個很高的訂單	a tall order
一個必要的邪惡	a necessary evil
一個快一個	a quick one
一個意見的問題	a matter of opinion
一個或兩個	one or two
一個戲劇的話	a play on words
一個接一個	one by one
一個新的	a new one
一個早期的墳墓	an early grave
一個月的味道	flavour of the month
一個月的時間	time of the month
一個杯子的遊戲	a mug's game
一個標記	one's mark
一個正確的	a right one
一個清晨	an early night
一個漂亮的一分錢	a pretty penny
一個火球	a ball of fire
一個男人的男人	a man's man
一個直的臉	a straight face
一個粗暴的車	a rough ride
一個纏結的網頁	a tangled web
一個肉體	one flesh
一個肩膀哭泣	a shoulder to cry on
一個芯片在肩上	a chip on one's shoulder
一個芯片掉了舊的塊	a chip off the old block
一個觀察的鍋從不沸騰	a watched pot never boils
一個討厭的人	a nasty one
一個記錄的問題	a matter of record
一個跳躍	one jump ahead
一個踢在牙齒	a kick in the teeth
一個達到目的的手段	a means to an end
一個預期的結論	a foregone conclusion
一兩件事	a thing or two
一分未得	scoreless
一分耕耘一分收穫	no pain, no gain
一分鐘	by the minute
一切 -	all the - 
一切嚴肅	in all seriousness
一切手段	by all means
一切無辜	in all innocence
一切都	one's all
一切都不會丟失	all is not lost
一切都好	all to the good
一切都結束了	all ends up
一切都走了	all the go
一切順利結束	all's well that ends well
一半的	the half of it
一半的戰鬥	half the battle
一半的時間	half the time
一半的機會	half a chance
一口清新的空氣	a breath of fresh air
一口餵食	a mouth to feed
一句話	at a word
一句話	in a word
一堆五味子	bunch of fives
一塊一片	piece by piece
一塊小便	a piece of piss
一塊水	piece of water
一塊蛋糕	a piece of cake
一壺金	pot of gold
一大堆	a big deal
一大堆	a great many
一天	by the day
一天	one day
一天一天	day in, day out
一天休息	break of day
一天的光	the light of day
一天的順序	the order of the day
一如既往	as always
一對一	one for one
一年又一天	a year and a day
一式三份	in triplicate
一式兩份	in duplicate
一式四份	in quadruplicate
一張玫瑰床	a bed of roses
一手交錢一手交貨	cash and carry
一把	fistful
一把雙刃劍	a double-edged sword
一擊即中	put a sock in it
一擲一息	a stone's throw
一整	after a sort
一會兒	in a moment
一朝被蛇咬十年怕井繩	once bitten, twice shy
一本開放的書	an open book
一束歡樂	a bundle of joy
一束神經	a bundle of nerves
一杯	glassful
一柄	edged
一根乾草堆裡的針	a needle in a haystack
一根稻草在風中	a straw in the wind
一桶	over a barrel
一桶笑	a barrel of laughs
一條大魚	a big fish
一條沙子	a rope of sand
一條紅色的抹佈公牛	a red rag to a bull
一條細線	a fine line
一條通往無處的路	a road to nowhere
一條魚出水	a fish out of water
一棵樹	up a tree
一槍在手臂	a shot in the arm
一樣一樣	one and the same
一樣的	the very same
一次	at a time
一次	at one time
一次全部	all at once
一次又一次	again and again
一次和未來	once and future
一次或兩次	once or twice
一次會議	a meeting of minds
一步步	step by step
一毛錢	on a dime
一毛錢一打	a dime a dozen
一無是處	not for nothing
一生	of a lifetime
一生一片	a slice of life
一盒技巧	box of tricks
一直	all along
一直到今天	hither and yon
一直笑到銀行	be laughing all the way to the bank
一碗櫻桃	a bowl of cherries
一磚一瓦	brick by brick
一種	a kind of
一種	of a kind
一筆交易	a deal of
一經請求	on demand
一罐蠕蟲	a can of worms
一臂長	at arm's length
一臉。	a slap in the face
一致	in line
一致	with one accord
一致的看法	see eye to eye
一舉兩得	kill two birds with one stone
一般來說	in general
一艘沉沒的船	a sinking ship
一英里一分鐘	a mile a minute
一英里的俱樂部	the mile-high club
一袋土豆	a sack of potatoes
一袋技巧	a bag of tricks
一袋骨頭	a bag of bones
一觸即發	a touch
一起來	come along
一起來	in tandem
一起做一個人的行為	get one's act together
一起得到一個狗屎	get one's shit together
一起玩	play along
一路走來	all the way
一路走來	go one's way
一路走來	out of one's way
一輪	round about
一輪	round on
一遍又一遍	over and over
一開始就開始	a head start
一隻小鳥告訴我	a little bird told me
一隻狼在羊的衣服	a wolf in sheep's clothing
一隻猴子在背上	a monkey on one's back
一隻眼睛和一顆牙齒	an eye for an eye and a tooth for a tooth
一隻眼睛打開睡覺	sleep with one eye open
一隻自由的手	a free hand
一飲而盡！	bottoms up!
一首歌	for a song
一首歌和舞蹈	a song and dance
一馬鎮	one-horse town
一點一點地	little by little
一點也不	not at all
一點都沒事	a bit of all right
一點點	a bit
一點點地	bit by bit
七個致命的罪惡	the seven deadly sins
七海	the seven seas
三個歡呼聲	three cheers
三個臭皮匠頂個諸葛亮	two heads are better than one
三個部分	three parts
三思而後行	look before you leap
三思而後行	think twice
三盧比	the three Rs
三重	triplication
上	go up
上下	on and on
上下文	contextual
上下文	contextually
上了桿	up the pole
上來	come up
上來了	on the up and up
上來玫瑰	come up roses
上升到場合	rise to the occasion
上升和發光	rise and shine
上和下	up and down
上地殼	the upper crust
上市	go public
上帝保佑	God bless
上帝的兒子	God the Son
上帝的父親	God the Father
上帝的真理	God's truth
上帝的祈禱者	the Lord's Prayer
上帝的禮物	God's gift
上帝的英畝	God's acre
上帝的行為	act of God
上帝禁止	God forbid
上帝給予	God grant
上氣不接下氣	out of breath
上法庭	go to court
上身	chested
下一個世界	the next world
下一行	next in line
下中間	down the middle
下來	be down to
下來	come down on
下來	come down with
下來	get down
下來	get down to
下來	go down on
下來派克	come down the pike
下到地面	down to the ground
下去	go down
下去	go under
下台	step down
下巴	jawed
下廁所	go down the toilet
下擺和aw	hem and haw
下死了	drop dead
下沉	sink in
下沉	sinkage
下沉或游泳	sink or swim
下蓋	under cover
下車	get off
下車	get off on
下車	go off
下鎖和鑰匙	under lock and key
下鎮	down town
下降到	fall to
下降工具	down tools
下雨天	a rainy day
下雨檢查	take a rain check
不，你不要！	no you don't!
不一會兒太早了	not a moment too soon
不一致性	discordance
不入虎穴，焉得虎子	nothing ventured, nothing gained
不公平	no fair
不再	no longer
不再	no more
不出來	not out
不勝	winless
不可戰勝的	beatable
不可收拾	out of hand
不合格	out of gear
不合比例	out of proportion
不同	differently
不同的筆劃為不同的人	different strokes for different folks
不含蛋	eggless
不回報的點	the point of no return
不在你的生活	not on your life
不在你的肚皮上	not on your nelly
不在場	out of court
不夜城	nightless
不好意思	not take kindly to
不好的	a bad lot
不好的感覺	hard feelings
不好說	sad to say
不妨	might as well
不完全是	not exactly
不完全的	not quite
不尋常的	out of the ordinary
不少於	no fewer than
不少於	not least
不工作	out of work
不必要	needlessly
不必要	not necessarily
不忘記 - 	not forgetting - 
不怕	no fear
不惜一切代價	at any price
不想知道	not want to know
不掛斷	hang on
不採取沒有答案	not take no for an answer
不擇手段	by fair means or foul
不是Temptable	temptable
不是一件事	not a thing
不是一半	not half
不是一點	not a bit
不是一點點	not a little
不是完整的	not the full quid
不是幾個	not a few
不是很漂亮的景象	not a pretty sight
不是板球	not cricket
不是特別的	not very
不是補丁	not a patch on
不是那個	not that
不是香腸	not a sausage
不檢點	loiterer
不正確的頭腦	not right in the head
不求回報	for nothing
不用了	no thanks to
不用擔心	not to worry
不用說	go without saying
不用說	needless to say
不相干	have nothing to do with
不知所措	at a loss
不知道	not know that
不知道這個詞的意思	not know the meaning of the word
不確定性	uncertainly
不笑事	no laughing matter
不管	no matter
不給狗屎	not give a shit
不能做	no can do
不能忍受鬼魂的機會	not stand the ghost of a chance
不脛而走	spread like wildfire
不至於	not in the least
不舒服	ill at ease
不著邊際	neither here nor there
不要呼吸	don't hold your breath
不要少	no less
不要愚蠢的傻子	not suffer fools gladly
不要打電話給我們，我們會打電話給你	don't call us, we'll call you
不要把太好點了	not to put too fine a point on it
不要煩我	give me a break
不要聰明	be none the wiser
不要通知	take no notice
不要野餐	be no picnic
不認識亞當的人	not know someone from Adam
不說	not to say
不說話	not to speak of
不近	not nearly
不過，	none the less
不錯	pretty please
不開玩笑	no kidding
世界公民	citizen of the world
世界是你的牡蠣	the world is your oyster
世界末日	the end of the world
世界的人	man of the world
世界的屋頂	the roof of the world
世界的方式	the way of the world
世界的重量	the weight of the world
世界頂級	on top of the world
丟掉名字	drop names
丟掉鑰匙	throw away the key
丟臉	lose face
並排	side by side
並肩	shoulder to shoulder
並駕齊驅	neck and neck
中大獎	hit the jackpot
中間無處	the middle of nowhere
串出來	string out
串起來	be strung out
主席	in chief
主日	the Lord's Day
主樣	lord-like
主的晚餐	the Lord's Supper
之上	up above
之前	previous to
之前	prior to
之前	up before
之杖	waker
乍一看	at first glance
乍看上去	at a glance
乖乖	obediently
乘坐	ride on
乘船	take ship
乞丐不能選擇	beggars can't be choosers
也只是	only too
也可以	may as well
也就是說	that is to say
也沒有	none too
乾了	come up dry
乾了	dry out
乾涸	dry up
乾涸	run dry
乾淨利落	plain and simple
乾淨的健康賬單	clean bill of health
乾燥	dryness
亂七八糟	at sixes and sevens
事實上	as a matter of fact
事實上	in point of fact
事實上	in reality
事實上	in truth
事實與數據	facts and figures
事情的事實	the fact of the matter
事情的形狀來了	the shape of things to come
事情的方案	the scheme of things
五十步笑百步	the pot calling the kettle black
交出	hand over
交叉線	crossed line
交易	trade on
交易技巧	tricks of the trade
交貨	deliver the goods
交鋒	cross swords
亮度	brightness
亮度	lightness
人的時刻	man of the moment
人起來	man up
人跡罕至的地方	off the beaten track
人類仁慈的牛奶	milk of human kindness
人類最好的朋友	man's best friend
什麼	what of
什麼不喜歡？	what's not to like?
什麼不是	and what not
什麼也沒說	to say nothing of
什麼名字？	what's in a name?
什麼是新的	what's new
什麼樂趣！	what fun!
今天在這裡，明天走了	here today, gone tomorrow
今天就這樣吧	call it a day
介入;涉足	step in
他們說	they say
他和她的	his and hers
他媽的	fuck all
他媽的	fuck off
他媽的人	fuck someone up
他媽的人過了	fuck someone over
付出努力	effortful
付出寶貴的代價	pay dearly
付款人	payer
付清	pay off
付錢的人叫調	he who pays the piper calls the tune
代替	in place of
代替	inside of
代表	stand for
令人難以置信	beyond belief
以......為代價	at the expense of
以...的觀點	in view of
以一種說話的方式	in a manner of speaking
以上懷疑	above suspicion
以上的位	above the bit
以任何方式	by any means
以前一直在那裡	have been there before
以及	as well
以及	as well as
以名義	in the name of
以壞的方式	in a bad way
以外	other than
以小劑量	in small doses
以後再	ever again
以成本	at cost
以此為目的	with a view to
以武力	by force of
以溢價	at a premium
以神的名義	in God's name
以結的速度	at a rate of knots
以至於	so much so that
以英寸	by inches
以著名聞名	famous for being famous
以防萬一	just in case
仰望	look up to
任何一天	any day
任何人的猜測	anybody's guess
任何人的遊戲	anyone's game
任何地方附近	anywhere near
任何數量	any number of
任何數量的	any amount of
任何港口在風暴中	any port in a storm
任何狀況之下	in any case
任何老	any old
任何老怎麼樣	any old how
任性	willed
任期安全	security of tenure
伊利亞群島	the Elysian Fields
休息一下	give it a rest
休息一下	make a break for
休息營	break camp
休閒中	at leisure
估計	reckon with
伸出一英里	stick out a mile
伸出來	stick out
伸出來	stick out for
伸出來像一個痛苦的拇指	stick out like a sore thumb
伸展	stretchable
但對於	but for
但是	but that
但是之後	but then
但這是另一個故事	but that's another story
位在一邊	bit on the side
位於	lie in
住在一起	live together
住在過去	live in the past
作品	piece of work
作樂	make merry
作為一個人	as one man
作為一個整體	as a whole
作為一個開始	for a start
作為一個項目	be an item
作為交換	in exchange
作為回報	in return
作為基本規則	as a general rule
作為規則	as a rule
作為記錄	for the record
你不知道嗎	don't you know
你再去了	there you go again
你在做什麼？	what are you on?
你太無恥了	shame on you
你好嗎？	how do you do?
你會怎麼樣	what you will
你有什麼快樂？	what's your pleasure?
你有它	there you have it
你父親怎麼樣	how's your father
你的	up yours
你的屁股！	up your arse!
你離題了	out of context
佩戴者	wearer
使...能夠	to let
使它大	make it big
使它快樂	make it snappy
使成績進步	make the grade
使某人失望	let someone down
使者	bringer
使自己稀缺	make oneself scarce
使運行	make the running
來乾淨	come clean
來了	come round
來了	come under
來什麼可能	come what may
來休息	come to rest
來來去吧	come and go
來來回回	back and forth
來到	come to
來到之間	come between
來到地獄或高水	come hell or high water
來吧	bring it on
來吧	come about
來吧	come around
來吧	come at
來吧	come before
來吧	come for
來吧	come forward
來吧	come on
來吧	come on to
來吧	come one's way
來吧	come right
來吧	come upon
來吧	to come
來年齡	come of age
來年齡	coming of age
來強壯	come on strong
來得便當去得快	easy come, easy go
來想想吧	come to think of it
來打擊	come to blows
來源	at source
來的	come of
來短	come short
來自	as from
來自	come from
來自後面	come from behind
來自海外	from overseas
來茬	come a cropper
例如	for example
例如	for instance
供不應求	in short supply
供應	on supply
供應商	supplier
供需	supply and demand
依照	stick to
依稀	dimly
依靠	bank on
便利地	handily
便士下降了	the penny dropped
便宜又快樂	cheap and cheerful
便宜又討厭	cheap and nasty
係好安全帶	belt up
保存臉	save face
保守	conservatively
保守主義	conservatism
保持一些東西	keep something from
保持一些東西	keep something in
保持一個人	keep someone in
保持下來	keep down
保持人	keep someone up
保持你的啄食	keep your pecker up
保持你的襯衫	keep your shirt on
保持公司	keep company with
保持和平	keep the peace
保持外表	keep up appearances
保持媽媽	keep mum
保持房子	keep house
保持所有的ace	hold all the aces
保持時間	keep time
保持步伐	keep step
保持秩序	keep rank
保持自己	keep to oneself
保持自己的腳	keep one's feet
保持良好	stay well
保持觀察	keep watch
保持身體和靈魂在一起	keep body and soul together
保持頭腦	keep one's head
保釋後	post bail
保重	take care
保險槓到保險槓	bumper-to-bumper
信不信由你	believe it or not
信任投票	vote of confidence
信用到期的信用	credit where credit is due
信號燈	winker
信貸	on credit
信貸額度	line of credit
修理者	mender
俯仰	pitch up
俱樂部會員	clubber
倍增	doubler
倒orn	pour scorn on
倒在上面	pour it on
倒退	fall back
倒酒	pourer
倚	lean on
借款人	borrower
借用	loaner
借記方	the debit side
值得一提的	mentionable
值得信賴	trustable
值得懷疑	doubtable
值得獎牌	deserve a medal
假	falsely
假上身	dummy up
假死	play possum
假裝沒看見	turn a blind eye
偉大和好的	the great and the good
偏激	extremeness
做	do by
做whoopee	make whoopee
做一些事情	do something over
做一些事情	make something up
做一些好事	make something good
做一個	do one
做一個乾淨的掃	make a clean sweep
做一個人	do someone up
做一個傻瓜	make a fool of
做一個嘲弄	make a mockery of
做一個戲	make a play for
做一個數字	do a number on
做一個比賽	make a match
做一個直線	make a beeline for
做一個美德	make a virtue of
做一個誠實的女人	make an honest woman of
做一個跑步者	do a runner
做一個雙層床	do a bunk
做一個音調	make a pitch
做一個飛濺	make a splash
做一頓飯	make a meal of
做事情	do things to
做什麼的？	what for?
做伎倆	do the trick
做做	make do
做切割	make the cut
做午餐	do lunch
做和做	up and doing
做好後	make after
做好準備	make ready
做完了	done for
做得像	make like
做得好	do good
做得很多	make much of
做愛	make love
做或打破	make or break
做或死	do or die
做戰鬥	do battle
做更多的傷害比好	do more harm than good
做某事	do something in
做某事	do something out
做某事	make something of
做某人	do someone in
做某人的頭	do someone's head in
做正確的	do right by
做水	make water
做為	do for
做生意	do the business
做的	do with
做自己的展覽	make an exhibition of oneself
做藥物	do drugs
做記錄	take note
做論文	make the papers
做起來	do up
做這個工作	do the job
做運動	make sport of
做體面的事情	do the decent thing
做點事情	do something up
做點東西	make something over
停下來	put a stop to
停下來	stop out
停在附近	stick around
停止	stop short of
停止印刷	out of print
停止死亡	stop dead
停止演出	stop the show
停止短	stop short
健全	bodied
健康	wellness
健談	talker
側身	sideways on
偵察者	scouter
偶然的機會	an even chance
偷偷	on the sly
偷工減料	cut corners
偽稱	palmed
傑克離開	jack off
備份	back up
備查	for future reference
傲然	proudly
傳下去	pass off
傳出	pass out
傳遞	pass on
傳遞一些東西	pass something over
傳遞包裹	pass the parcel
債券	in bond
傻子急於天使害怕踩踏	fools rush in where angels fear to tread
傾盆大雨	rain cats and dogs
僅在名義上	in name only
僅有的一個	one and only
像cl子一樣	like the clappers
像一個惡魔	like a demon
像一個炸彈一樣	go like a bomb
像一個蝙蝠從地獄	like a bat out of hell
像一堆磚	like a ton of bricks
像一家中國店的公牛	like a bull in a china shop
像一槍	like a shot
像一連串	like a streak
像任何東西	like anything
像你一樣做	as you do
像做夢一樣	like a dream
像光一樣出去	go out like a light
像兔子一樣繁殖	breed like rabbits
像地獄一樣	like hell
像地球上沒什麼	like nothing on earth
像山一樣古老	as old as the hills
像房子一樣安全	as safe as houses
像水一樣	like water
像水蛭	like a leech
像沒人做生意	like nobody's business
像火炬的飛蛾一樣	like a moth to the flame
像無頭雞	like a headless chicken
像生氣	like mad
像發瘋的	like crazy
像石頭一樣	rock-like
像罪惡	like sin
像羔羊一樣宰殺	like a lamb to the slaughter
像蒼蠅一樣死亡	die like flies
像那樣	like that
像風一樣	like the wind
像魔術	like magic
像魔鬼一樣	like the devil
像魚一樣喝	drink like a fish
僵硬	stiffly
僵硬的板子	stiff as a board
價格多少	what price
儀式儀式	rite of passage
儘管	in spite of
儲庫	reserver
允許我	allow me
允許我	permit me
兄弟在懷裡	brothers in arms
充分	to the full
充分利用	make the best of
充分利用	make the most of
充實	fleshed
充滿了	full out
充滿了豆	full of beans
充滿了邊緣	full to the brim
充滿溢出	full to overflowing
充滿煙霧的房間	smoke-filled rooms
充滿自己	full of oneself
充耳不聞	turn a deaf ear
充電	rechargeable
充電器	recharger
兇猛	fierceness
光明正大	fair and square
光陰	light and shade
克服	get over
免費	for free
免費	free of charge
免費乘車	a free ride
兒子的名分	sonship
兜圈子	beat about the bush
內克爾	necker
內外	the ins and outs
內心安寧	at peace
內特	netter
內疚	guiltily
全力以赴	all out
全力以赴	with all one's might
全唱，全跳舞	all-singing, all-dancing
全有或全無	all-or-nothing
全流程	in full flow
全濕了	all wet
全站	all standing
全能和最終	the be-all and end-all
全裸	bare all
全視圖	in full view
全部一起	all together
全部出發	all get-out
全部告訴	all told
全部在	all in
全部發現	all found
全部都一樣	all the same
全都死了	damn all
全都為了	all for
全開	full on
全面地	across the board
兩個錯誤都沒有權利	two wrongs don't make a right
公元前	before Christ
公平	fairness
公平交易	a fair deal
公平和正直	fairly and squarely
公平的dinkum	fair dinkum
公平的去	fair go
公平的比賽	fair game
公平競賽	play fair
公正	justness
公眾的眼睛	the public eye
公開的;當眾	in public
公雞的步行	cock of the walk
六最好的	six of the best
六英尺以下	six feet under
共享資源	sharer
共同或花園	common or garden
共同的好	the common good
共同貨幣	common currency
共同點	common ground
共同點	common thread
共同點	in common
共性	commonness
兵臨城下	under siege
其中的一種	one of a kind
其他地方	everywhere else
其餘的是歷史	the rest is history
具體	concretely
具體性	concreteness
再來？	come again?
再來一次	here we go again
再想一想	think again
再見	by the bye
再造	reinvention
冒煙	go up in smoke
冒險	take the plunge
冬天的死人	the dead of winter
冰山一角	the tip of the iceberg
冷卻	cooled
冷卻！	cool it!
冷的肩膀	the cold shoulder
冷竣	chillingly
冷舒適	cold comfort
冷酷的	feelingless
冷鋼	cold steel
冷靜	calmness
冷靜	coolly
冷靜下來	take the chill off
凌駕於法律之上	above the law
凍結一個人	freeze someone out
出了佣金	out of commission
出了問題	out of the question
出了照片	out of the picture
出了路	out of the way
出來	come out
出來	come out in
出來	come out with
出來	cop out
出來	have it out
出來	out for
出來	out of it
出去	get out
出去	go out
出去做點什麼	out to do something
出去吃午餐	out to lunch
出去玩	hang out
出售	on sale
出席會議	in attendance
出於同樣的原因	by the same token
出於興趣	of interest
出汗了	sweat it out
出生和繁殖	born and bred
出發	set off
出發	set out
出租	for rent
出租人	leaser
出錯	go wrong
出門	out of doors
刀割樣	knife-like
刁難地	despiteful
分享一下	share a moment
分享和分享	share and share alike
分割	cut up
分心	to distraction
分手	break up
分揀機	sorter
分級機	sizer
分裂的頭髮	split hairs
分解	break down
分開但平等	separate but equal
分開差異	split the difference
分開的方式	parting of the ways
分隔器	separator
分離性	separateness
分頁	paged
分頁	tabbed
切丁	dicer
切了一個人	cut someone up
切入	cut in
切入某人	cut someone in
切入正題	cut to the chase
切出來	cut it out
切割一下	cut a dash
切割並運行	cut and run
切成	cut into
切斷東西	cut something off
切斷某人	cut someone off
切斷自己的鼻子，盡量避開臉	cut off one's nose to spite one's face
切松	cut loose
切段，曬乾	cut and dried
切片和骰子	slice and dice
切片機	slicer
切芥末	cut the mustard
初學者的運氣	beginner's luck
初步的	preliminary to
別客氣	be my guest
別想它了	think nothing of it
別提了	don't mention it
別擔心	no worries
別的東西	something else
別緊張	take it easy
別說了	say no more
利己	hoggish
利用	make use of
利用	take advantage of
到T	to a T
到了	on to
到了這一點	to the point
到今天	to the day
到今天	to this day
到位	in place
到位	to bits
到地獄	to hell with
到場	turn up
到壞的	to the bad
到大小	to size
到天空	to the skies
到底	in the end
到底部	get to the bottom of
到最後	to the finish
到某處	get somewhere
到核心	to the core
到歹徒	to the gunwales
到死亡	to the death
到王國來	to kingdom come
到現在為止還挺好	so far so good
到生命中	to the life
到痛苦的盡頭	to the bitter end
到目前為止	by far
到第n學位	to the nth degree
到第一個基地	get to first base
到腳下	to one's feet
到處走走	get around
到達	get to
到達	reachable
到骨頭	to the bone
到骨髓	to the marrow
到鰓	to the gills
制定	draw up
制定一個計劃	make a plan
制定法律	lay down the law
制衡	checks and balances
刺傷了一個人在後面	stab someone in the back
刺戳	prodder
刺激	spurred
刺輥	licker
剁碎	the chop
削減交易	cut a deal
前方的街道	streets ahead
前進	forward of
前進	go ahead
前進	go forward
前面	in front
剛性	stiffness
剝離	come off
剪下	cut out
剪切和粘貼	cut and paste
創造性思考	think outside the box
創造歷史	make history
劃傷表面	scratch the surface
劇情增厚	the plot thickens
劍狀	sword-like
力量的均衡	balance of power
功能文盲	functionally illiterate
加入俱樂部	join the club
加工	processable
加強板塊	step up to the plate
加快速度	up to speed
加油！	up the ante
加緊	gear up
加載為熊	loaded for bear
助力器	strengthener
助推器	tunneller
努力	make an effort
努力	with effort
勇敢	braveness
勇敢地	bravely
勇敢地	gamely
動子和搖床	mover and shaker
動手	hands-on
動脈硬化	hardening of the arteries
動起來	get moving
動輒	at every turn
勝算	winnable
勞登	louden
勻	evenly
勾選某人	tick someone off
包一記重拳	pack a punch
包機	plucker
包熱	pack heat
包糖	bagful
包裝像沙丁魚	packed like sardines
包裝出來	packed out
匆忙	in a hurry
化妝	make up
化為碎片	fall to pieces
匹配	match up to
匹配	to match
十分之九	nine tenths
十分之九	nine times out of ten
十分之十	ten out of ten
十字架的標誌	sign of the cross
十對一	ten to one
十幾個	by the dozen
千分之二	coverable
千鈞	supremely
升空	lift off
升級程序	upgrader
升降機	lifter
午餐的女士們	ladies who lunch
半生不熟	rawness
半豎起	half-cocked
卑賤	meanly
卡住	chuck up
卡特	carter
印象的	impressional
危險	at stake
即使	even if
即使	even though
即使如此	even as
即使是這樣	even so
卵石	pebbly
卷上	on a roll
厚厚	thickly
厚而快	thick and fast
原則上	in principle
原則上	on principle
厲害	strike it rich
去！	go to!
去pfft	go pfft
去ung	go bung
去一個更好	go one better
去世	pass away
去乞討	go begging
去做	go for
去備用	go spare
去加油	take a hike
去合法	go legit
去吧	get going
去吧	go about
去吧	go at
去吧	to go
去吸一個雞蛋	go suck an egg
去嚐嚐	to taste
去地方	go places
去地獄	to hell
去地球	go to earth
去地面	go to ground
去墊子	go to the mat
去彈道	go ballistic
去戰爭	go to war
去把事情弄得更糟	to make matters worse
去搞清楚！	go figure!
去放風箏	go fly a kite
去整個豬肉	go the whole hog
去本地人	go native
去梨形	go pear-shaped
去死吧	go to hell
去沒有	go without
去法律	go to law
去活	go live
去浪費	go to waste
去海邊	go to sea
去燒傷	go for the burn
去牆上	go to the wall
去狗	go to the dogs
去皮	skinless
去睡午覺	go nap
去睡覺	get to sleep
去睡覺	go to sleep
去短	go short
去碎片	go to pieces
去秋天	take the fall
去突擊隊	go commando
去粉碎	go to smash
去精神	go mental
去舷外	go overboard
去荷蘭語	go Dutch
去過也做過	been there, done that
去遠方	go the distance
去郵政	go postal
去鉑金	go platinum
去鍋	go to pot
去鎮上	go to town
去額外的一英里	go the extra mile
去飛行	go flying
去騙子	go crook
去黃金	go gold
參加進來	come into play
參照系	frame of reference
參與	take part
又一樣	same again
及時	in time
反	reverser
反之	contrarily
反對	as against
反對	come up against
反對	in opposition
反對	kick against
反對	over against
反對	run against
反對	run up against
反對	take against
反對	up against
反對太陽	against the sun
反對時間	against time
反對糧食	against the grain
反對者	objector
反對自己的願望	against one's wishes
反對自然	against nature
反彈	on the bounce
反彈	on the rebound
反轉費用	reverse the charges
反過來	in turn
反饋	feed back
取一些東西	take something off
取代	take the place of
取樣器	corer
取決於	depending on
取決於	up to
取笑	poke fun at
取自	take from
受其影響	under the influence
受害	victimhood
受審	stand trial
叢林	jungly
叢林的法律	the law of the jungle
口	mouthed
口哨迪克西	whistle Dixie
古人	the ancients
另一件事	the other thing
另一個	one another
另一半的生活如何	how the other half lives
另一方面	on the other hand
只是	only just
只是工作	just the job
只是靜靜地	just quietly
只有	nothing but
只有這麼多	only so much
只要	as long as
只要	in so far as
只要	so long as
只要有強大的意志，必有一條路為你開	where there's a will there's a way
叫停	call a halt
叫它退出	call it quits
叫鐵鍬	call a spade a spade
可下沉	sinkable
可以掌握的小東西，勝過沒有把握的大東西	a bird in the hand is worth two in the bush
可以解決	fixable
可供出售	sellable
可保持	holdable
可借鑒	referable
可儲存	storable
可兌換	exchangeable
可出租	leasable
可匹配	matchable
可升高	raisable
可命名	nameable
可回收	returnable
可容忍	sufferable
可怕的二人	terrible twos
可怕的很多	an awful lot
可愛	prettiness
可愛的jubbly	lovely jubbly
可折疊	foldable
可捲曲	rollable
可接受	acceptably
可控	controllably
可控制	controllable
可控性	controllability
可握	graspable
可撕裂	tearable
可操縱	steerable
可支配	spendable
可旋	screwable
可映射	mappable
可棄	droppable
可檢查	checkable
可治療	treatable
可清洗	cleanable
可測試	testable
可測試性	testability
可滿足	satisfiable
可熔	meltable
可牽引	towable
可獲取	acquirable
可玩	playable
可玩性	playability
可畏	terribleness
可知	knowable
可移動	shiftable
可簽名	signable
可編程	programmability
可編程的	programmable
可聽的	hearable
可能停止	stoppable
可能是對的	might is right
可複製	duplicable
可解釋	explainable
可觸摸	touchable
可訓練	trainable
可調光	dimmable
可證	provability
可證	provable
可證明	provably
可轉移	jumpable
可運行	runnable
可達性	reachability
可鎖定	lockable
可關閉	closable
可預期的	expectable
可點擊	tappable
司爐	stroker
吃東西	eat someone up
吃東西	eat something up
吃泥土	eat dirt
吃烏鴉	eat crow
吃進去	eat into
吃餃子	eat humble pie
各種	all sorts of
各種各樣的	all manner of
合意	acceptability
合理	make sense
吊索和箭頭	slings and arrows
同情地	pityingly
同樣在這裡	same here
同樣的差異	same difference
同樣的老，同樣的老	same old, same old
名垂青史	go down in history
吐出來	spit it out
吐出來	up the spout
吐氣	blow off steam
吐血	spit blood
向上拖	drag up
向上移動	upwardly mobile
向下南	down south
向下移動	downwardly mobile
向前	forwardly
向前	frontward
向前一步	step forward
向前付款	pay it forward
向北	up north
向南走	go south
向左	leftward
向左	leftwards
向後傾斜	lean over backwards
向後和向前	backwards and forwards
向後彎曲	bend over backwards
向西走	go west
向陽	sunward
吝嗇	fisted
含塵	dustiness
吸一口氣	catch one's breath
吸了	suck up
吸它看看	suck it and see
吸引力中心	centre of attraction
吸管	draw straws
吸起來	suck it up
吹一個洞	blow a hole in
吹個人	blow someone off
吹個人	blow someone out
吹個人	blow someone up
吹個人的心	blow someone's mind
吹冷熱	blow hot and cold
吹和吹	puff and blow
吹塊	blow chunks
吹掉	blow off
吹掉一些東西	blow something off
吹東西	blow something out
吹東西	blow something up
吹熄	blow out
吹進來	blow in
吹過來	blow over
吹鼻子	blow one's nose
吻屁股	kiss ass
呃起來	eh up
呆著	stay on
呈綠色的	greenish
呈褐色的	brownish
告訴別人	tell someone off
告訴它就是這樣	tell it like it is
告訴我另一個	tell me another
告訴我怎麼回事兒	tell me about it
呼叫收集	call collect
呼叫港	port of call
呼吸一下	hold one's breath
呼吸火	breathe fire
呼喊	shouter
命令查看	order to view
命名一天	name the day
命運比死亡更糟	a fate worse than death
咀嚼某人出來	chew someone out
咀嚼片	chewable
咀嚼者	chewer
咀嚼風景	chew the scenery
咆哮和狂歡	rant and rave
和---關聯	in relation to
和...一起	together with
和/或	and/or
和公司	and Co.
和公司	and company
和其餘的	and the rest
和所有	and everything
和所有爵士樂	and all that jazz
和某人在一起	be with someone
和自己一起玩	play with oneself
咖哩喜歡	curry favour
咬一口	take a bite out of
咬人的頭	bite someone's head off
咬住灰塵	bite the dust
咬嘴唇	bite one's lip
咬大了	bite the big one
品味血液	taste blood
品種是生活的香料	variety is the spice of life
哦耶？	oh yeah?
哪個是	which is which
哭了	cry off
哭泣	cry out for
哭泣犯規	cry foul
哭狼	cry wolf
唯一的那個	the one
問題	at issue
啞	dumbness
啟動	booted
啟示錄的四騎士	the Four Horsemen of the Apocalypse
啟航	set sail
啤酒和小吃	beer and skittles
啥時候	say when
善有善報惡有惡報	what goes around comes around
善良	hearted
喇叭狀	horn-like
喉	throated
喉嚨裡的腫塊	a lump in the throat
喘口氣	take breath
喜樂	blissfulness
喜歡	to one's liking
喜歡blazes	like blazes
喜歡在桶裡拍魚	like shooting fish in a barrel
喜歡拉牙	like pulling teeth
喜歡放牧的貓	like herding cats
喜歡的	the likes of
喜歡臭	like stink
喜歡與否	like it or not
喝桌子下的人	drink someone under the table
喝深	drink deep
喝酒和開車	drink and drive
喝酒狂鬧的人	rioter
喪盡天良	conscienceless
單刀	hilted
單打獨鬥	go it alone
單間	roomed
嗡嗡聲	boomy
嗯好	ja well
嘆了一口氣	breathe a sigh of relief
嘔吐	throw up
嘗試一下	try something on
嘴巴	mouth off
嘿嘿	what the hey
嘿起來	hey up
器	exchanger
噴出	spouted
嚴厲	sternness
嚴厲打擊	crack down on
嚴峻性	grimness
嚴正	sternly
嚴重打擊	hard hit
嚼嚼	chew the cud
囅	smilingly
四個崇高的真理	four noble truths
四十眨眼	forty winks
四處走走	go around
回來	come back
回來	get back at
回來了	fall back on
回到	get back to
回到前面	back to front
回到畫板	back to the drawing board
回去	go back
回去	go back on
回報率	rate of return
回家	come home
回家了	hit home
回家去棲息	come home to roost
回想	think back
回想起來	in retrospect
回擊	strike back
回暖	warmer
回望	look back
回水	back water
回答者	answerer
回錯馬	back the wrong horse
因果	cause and effect
因果關係鏈	chain of causation
因此	as such
因此	in consequence
因為	because of
因為失誤	by mistake
因為它是	as it were
因為某些原因	for some reason
因禍得福	a blessing in disguise
固化劑	hardener
固執	stubbornness
固執地	stubbornly
圈貨車	circle the wagons
國王的運動	the sport of kings
國際收支	balance of payments
國際社會	the international community
圍攻	lay siege to
園丁	gardener
圓	roundness
圓形	roundish
圖片中	in the picture
在	be at
在......之外	out of
在buff中	in the buff
在cosh下	under the cosh
在edgeways得到一個字	get a word in edgeways
在hock	in hock
在loggerheads	at loggerheads
在nip	in the nip
在pod中	in pod
在tenterhooks	on tenterhooks
在一個	at one
在一個人的遊戲的頂部	be at the top of one's game
在一個價格	at a price
在一個地方	in a spot
在一個小的方式	in a small way
在一個小鑰匙	in a minor key
在一個水平上	on a level with
在一個清澈的藍天	out of a clear blue sky
在一個生日禮服	in one's birthday suit
在一個範圍內	at a range of
在一個耳朵和另一個耳朵	in one ear and out the other
在一個身體	in a body
在一分鐘	at the minute
在一塊	in one piece
在一天結束	at the end of the day
在一定程度上	to a degree
在一定程度上	up to a point
在一小時內	within the hour
在一時衝動	on the spur of the moment
在一棵樹上	out of one's tree
在一段時間	at a stretch
在一英寸之內	within an inch of
在一起	in the altogether
在一輪	in the round
在一邊	on the side
在一頂帽子的下降	at the drop of a hat
在一點點	in little
在三葉草	in clover
在上	in on
在上下文中	in context
在上升	in the ascendant
在上升	on the rise
在上面	on it
在上面	on top
在世界上	in the world
在中游	in midstream
在中間	in the middle of
在主持下	under the auspices of
在主要	in the main
在之上	on top of
在之前	ahead of
在之後	in the wake of
在事件中	in the event
在事情上	in the matter of
在二手	at second hand
在人的	in the person of
在任何情況下	by any chance
在任何情況下	in no case
在休息	at rest
在位	in bits
在作品中	in the works
在你之後	after you
在你和我和牆之間	between you and me and the wall
在你夢裡	in your dreams
在你的痕跡上	on your marks
在你的臉上	in-your-face
在佳能	in canon
在便宜的	on the cheap
在信用方面	on the credit side
在修剪	in trim
在做的	on the make
在儲備	in reserve
在充滿的時間	in the fullness of time
在光天化日之下	in broad daylight
在全	in full
在八球後面	behind the eight ball
在公共汽車上扔一個人	throw someone under the bus
在公司	in company
在公園散步	a walk in the park
在公寓	on the flat
在公開場合	in open court
在具體	in the concrete
在典當	in pawn
在冰上	on ice
在冷血中	in cold blood
在凳子上	at stool
在前面	in front of
在前面	lie ahead
在前面	out front
在剪影	in silhouette
在剪輯	at a clip
在力量	in strength
在力量上	on the strength of
在包裡	in the bag
在升級	on the upgrade
在印像中	under the impression that
在原料	in the raw
在口袋裡	in pocket
在右邊	be in the right
在右邊	on the right side of
在司機座位上	in the driver's seat
在同一條船上	be in the same boat
在同一頁面上	on the same page
在呼吸下	under one's breath
在咒語下	under a spell
在哪裡	where it's at
在喝酒	in drink
在嘴裡下來	down in the mouth
在圖片中	be in pictures
在地上	on the ground
在地上很薄	thin on the ground
在地平線上	on the horizon
在地毯上	on the carpet
在地球上	on earth
在城裡唯一的遊戲	the only game in town
在堆裡	in a heap
在墊子上	on the mat
在增加	on the increase
在墳墓裡有一隻腳	have one foot in the grave
在外過夜	sleep out
在外面	at the outside
在外面	on the outside
在外面	outside of
在外面看	on the outside looking in
在夜裡碰到的東西	things that go bump in the night
在大的	at large
在大綱上	in outline
在天鵝絨上	on velvet
在奢華的一圈	in the lap of luxury
在好的時候	in good time
在好轉	on the mend
在婚姻中	in marriage
在字符串上	on a string
在它	at it
在它之間開一個楔子	drive a wedge between
在它的整體	in its totality
在它的臉上	on the face of it
在安全的手中	in safe hands
在安靜	on the quiet
在家	at home
在家庭的方式	in the family way
在寒冷中出來	out in the cold
在寒冷的一天	in the cold light of day
在實例	at the instance of
在實踐中	in practice
在封面下	under cover of
在尊重	in deference to
在小提琴上	on the fiddle
在小時	on the hour
在小狗	in pup
在小跑上	on the trot
在小鹿	in fawn
在屁股上	on the bum
在居住	in residence
在岩石和硬的地方之間	between a rock and a hard place
在岸上	on shore
在岸邊	in shore
在工作中	on the job
在市場上	on the market
在布丁俱樂部	in the pudding club
在帆下	under sail
在平行下	in parallel
在平衡中	in the balance
在平裝書	in paperback
在年級	at grade
在床上	in bed with
在底部	at bottom
在底部	be at the bottom of
在廢墟中	in ruins
在廣場上	on the square
在延遲	in retard
在弓上	on the bow
在彩虹的盡頭	at the end of the rainbow
在很大的方式	in a big way
在很大程度上	to a great extent
在後面	behind the bit
在後面	in back
在後面的燃燒器	on the back burner
在得分上	on the score of
在徘徊	on the prowl
在微型	in miniature
在心裡	at heart
在心跳中	in a heartbeat
在性質上	in the nature of
在恢復	in recovery
在愛和戰爭中都是公平的	all's fair in love and war
在我心裡	to my mind
在我的屍體上	over my dead body
在我的書裡	in my book
在房子上	on the house
在所有	at all
在所有	in all
在所有的可能性	in all likelihood
在所有的天氣	in all weathers
在所有的概率	in all probability
在所有點	at all points
在手裡	in hand
在手錶上	be on the watch
在抓住	in the grip of
在抹布上	be on the rag
在抽像中	in the abstract
在括號中	in parenthesis
在按鈕上	on the button
在推動	at a push
在搗蛋	in tatters
在整體上	in whole
在斜坡	at the slope
在斬塊上	on the chopping block
在旅途中	on the go
在旋轉	in a whirl
在旗幟下	under the banner of
在日食	in eclipse
在時間之前	before time
在普通的	in ordinary
在曠野的聲音	a voice in the wilderness
在更多的方式比一個	in more ways than one
在書上	on the books
在最好的時候	at the best of times
在最後	be at the end of
在最後的手段	in the last resort
在最早	at the earliest
在會議中	in conference
在會議中	in session
在服務	in service
在望	in sight
在未來	in future
在本質上	in essence
在板凳上	on the bench
在架子上	on the shelf
在某人的拇指下	under someone's thumb
在某人的背後	behind someone's back
在某人的腦海裡	on someone's mind
在某人的鼻子下	under someone's nose
在某個角度	at an angle
在某物上	be onto something
在某種程度上	in some sort
在根	at root
在桅杆前	before the mast
在桌子上	on the table
在桌子下面	under the table
在業務	in business
在業務中	in the business of
在極端	in the extreme
在槍下	under the gun
在樂趣	in fun
在樑上	on the beam
在標記上	on the mark
在樹林裡做狗屎嗎？	do bears shit in the woods?
在機架上	on the rack
在機翼上	on the wing
在檔案	on file
在檢查	in check
在櫃檯	over the counter
在櫃檯後面	behind the counter
在權力之中	in the power of
在歌曲	on song
在武器	in arms
在武器下	under arms
在歪斜	on the skew
在死亡的門口	at death's door
在氣味上	on the scent
在水下	under water
在水平上	on the level
在水果中	in fruit
在沙發上	on the couch
在法庭上	in court
在泡沫上	on the bubble
在波浪的頂端	on the crest of a wave
在洗	in the wash
在洞裡	in holes
在洞裡	in the hole
在流	on stream
在海上	at sea
在海上	on the sea
在海灣	at bay
在深處	in deep
在清楚	in the clear
在減速	on the wane
在游泳	in the swim
在湯裡	in the soup
在滑板上	on the skids
在演唱會	in concert
在火下	under fire
在火焰中上升	go up in flames
在火車上	in the train of
在火車上	in train
在烤箱裡放一個饅頭	have a bun in the oven
在熔爐裡	in the melting pot
在熱水中	in hot water
在牆上飛	fly on the wall
在牙齒裡	in the teeth of
在牛奶中	in milk
在物種	in specie
在狗屎	in the shit
在玫瑰下	under the rose
在球上	on the ball
在瓶子裡	in bottle
在瓷磚上	on the tiles
在生活的土地上	in the land of the living
在產品上	on the prod
在甲板上	on deck
在當下的熱度	in the heat of the moment
在痛苦中	in the throes of
在皮膚下	under the skin
在盤子上	on a plate
在盤子上	on one's plate
在相機中	in camera
在看	look in
在真空中	in a vacuum
在眼前	at hand
在瞬間	on the instant
在短期內	in short order
在石頭上	on the rocks
在碎片	in shreds
在碼頭	in dock
在社區照顧	care in the community
在神的一圈	in the lap of the gods
在禮物中	in the gift of
在秘密	in secret
在移動	on the move
在空中	in the air
在空中	up in the air
在第一手	at first hand
在第七天	in seventh heaven
在第二位	in the second place
在等待	in wait
在管線中	in the pipeline
在粉紅色	in the pink
在粗糙的	in the rough
在紙上	on paper
在線	in line for
在線上	on the line
在線下	under the wire
在線下方	below the line
在線以上	above the line
在繩子上	on the rope
在繩索上	on the ropes
在繪圖板上	on the drawing board
在續集	in the sequel
在罐裡	in the can
在羊羔	in lamb
在群眾中	in the mass
在翅膀上禱告	on a wing and a prayer
在翅膀裡	in the wings
在考慮中	under consideration
在聯賽	in league
在聲音中	in voice
在職責	in the line of duty
在肉體中	in the flesh
在背上	on one's back
在胚胎	in embryo
在胳膊下	under one's arm
在腰帶下面	below the belt
在腳下	on one's feet
在腳下	under foot
在腳下	under one's feet
在腳下	under the heel of
在腳趾上	on one's toes
在膝蓋上	on one's knees
在臀部	on the hip
在臉上	in one's face
在自己的蒸汽	under one's own steam
在自身	in itself
在與	in with
在舌頭上	on the tip of one's tongue
在船上	on board
在艉板上	over the transom
在艙口下	down the hatch
在芽裡	in bud
在草地上	at grass
在草地下	under the sod
在荷蘭	in Dutch
在蒸汽	in steam
在蒼白	in pale
在蔑視之下	beneath contempt
在薄冰上	on thin ice
在薄荷條件	in mint condition
在行動	in action
在行為上	in the act of
在行軍	on the march
在街上	on the streets
在裡面	on the inside
在裡面	pitch in
在裸體	in the nude
在製作中	in the making
在視野中	in view
在角上	on the horn
在記憶	in memory of
在該地區	in the region of
在該領域	in the field
在謹慎的一邊	err on the side of caution
在議程上	on the agenda
在豬	in pig
在賠率	at odds
在質量	in mass
在購物車	in the cart
在路上	at the trail
在路上	down the road
在路上	on the road
在路上碰撞	a bump in the road
在跳	on the hop
在蹄上	on the hoof
在躺下	in lay
在車隊	in convoy
在軌上	on track
在軌道上	on the rails
在輪子上	on wheels
在辯論中	under debate
在追捧	in hot pursuit
在這個日子裡	in this day and age
在這樣的情況下	in the event that
在這種情況下	in that case
在這種情況下	in that event
在通話	at call
在遊戲中	on the game
在運動	in sport
在運動軌跡上	on the campaign trail
在運行	on the run
在過量的	in excess of
在適當的時候	in due course
在邊界	in bounds
在邊緣周圍粗糙	rough around the edges
在那裡	at that
在那裡面	in that
在配置文件中	in profile
在酒吧後面	behind bars
在醒目的距離內	within striking distance
在鉤上	on the hook for
在錢上	on the money
在錨	at anchor
在錯誤的一面	on the wrong side of
在鍋中閃爍	flash in the pan
在鎮上	on the town
在鐵	in irons
在門上	on the door
在門口	at the door
在門環上	on the knocker
在閂鎖上	on the latch
在閉門後	behind closed doors
在開場	in the offing
在開放的天空下	under the open sky
在閒暇時	at one's leisure
在關於	be on about
在關鍵時刻	in the nick of time
在防守上	on the defensive
在附近	in the neighbourhood of
在附近	near at hand
在限度內	within limits
在院子裡	by the yard
在陽光下	under the sun
在隧道盡頭的燈光	light at the end of the tunnel
在雲下	under a cloud
在雲層	in the clouds
在電話裡	on the telephone
在需要時提供幫助的朋友才是真朋友	a friend in need is a friend indeed
在需要的時候	at need
在靠近胸前打一張牌	play one's cards close to one's chest
在預算	on a budget
在頭腦裡	in one's head
在顯微鏡下	under the microscope
在風中	on a wind
在風中扭曲	twist in the wind
在風車傾斜	tilt at windmills
在飛行中	in full flight
在飛行中	on the fly
在馬背上	on horseback
在馬鞍	in the saddle
在駝峰上	over the hump
在高處	on high
在鬆散	on the loose
在魔鬼和深藍色的大海之間	between the devil and the deep blue sea
在黑客	at hack
在黑暗中	in the dark
在黑暗中刺傷	a stab in the dark
在黑暗中射門	a shot in the dark
在黑暗中飛躍	a leap in the dark
在黑桃	in spades
在黑色	in the black
在黑色和白色	in black and white
在默認情況下	in default
在點上	on point
在鼻子上	on the nose
地下	ground down
地址形式	form of address
地獄為皮革	hell for leather
地獄的半英畝	hell's half acre
地獄的鐘聲	hell's bells
地球	the earth
地球上的鹽	the salt of the earth
地球的臉	the face of the earth
地轉移	shirted
均勻度	evenness
坐下	sit down
坐下	sit through
坐下來	sit back
坐下座位	take a back seat
坐在	sit by
坐在	sit in
坐在	sit in for
坐在	sit on
坐在判斷	sit in judgement
坐得漂亮	be sitting pretty
坐椅子	take the chair
坦白	own up
垂吊	dangly
埋在	muck in
埋葬斧頭	bury the hatchet
培養	bring up
基地	off base
基德	kidder
基本事實	nitty
堅固性	firmness
堅守	hold fast
堅定的手	a firm hand
堅持	hold forth
堅持	hold out
堅持	hold out for
堅持	keep to
堅持	stand on
堅持	stick at
堅持	stick by
堅持	stick up for
堅持	stick with
堅持下去	go hard with
堅持下去	hold hard
堅持下去	hold out on
堅持下去	stick it to
堅持住	hold on to
堅果類	nut-like
堅韌	hang tough
報告	on report
報告	reportable
場景變化	change of scene
堵	stop up
塊狀	blocky
塗抹	spreadable
塗油	anointment
塞滿了	get stuffed
填充它	stuff it
填塞	stuffer
填寫	fill in
填寫	fill out
填寫賬單	fill the bill
塵埃落定	the dust settles
墜落	come down
墜落	fall about
增加侮辱傷害	add insult to injury
壁到牆	wall-to-wall
壓榨機	presser
壓榨機	squeezer
壓模	stamper
壘打	bagger
壞心眼	sourness
壞心眼地	sourly
壞透地	wickedly
壯志凌雲	top gun
外出走動	out and about
外面的機會	an outside chance
多多益善	the more the merrier
多孔	holey
多少	how many
多少	how much
多指	fingered
多病	sickish
多遠	how far
夠了	right enough
夠味	flavoursome
夢	dreamless
夢想	dream on
夢想	pie in the sky
大C	the Big C
大事狂歡	paint the town red
大五	the big five
大人物	big shot
大像在房間裡	the elephant in the room
大塊錢	big bucks
大女生的上衣	big girl's blouse
大奶酪	big cheese
大小	sized
大小小	great and small
大屏幕	the big screen
大幅	sharply
大想法	the big idea
大棍子	the big stick
大概	just about
大男孩	the big boys
大笑一分鐘	a laugh a minute
大笑起來	raise a laugh
大聲哭泣	for crying out loud
大肚子的	bellied
大腦上的水	water on the brain
大腦屎	shit for brains
大膽	boldly
大自然的呼喚	call of nature
大自然的呼喚	the call of nature
大謊言	the big lie
大遊戲	the Great Game
大部分	for the most part
大驚小怪	make a fuss
天意	God willing
天才之卒	stroke of genius
天空才是極限	the sky is the limit
天開了	the heavens open
天鵝絨般的	velvety
太多了	too much
太大了，不能失敗	too big to fail
太對了	too right
太感謝了	thanks a million
太糟糕了	too bad
太聰明了一半	too clever by half
太遠	too far
太酷了學校	too cool for school
太長	so long
太陽在碼頭上	the sun is over the yardarm
太陽照耀時會讓乾草	make hay while the sun shines
太靠近了舒適	too close for comfort
夯	rammer
失去了	be lost on
失去了信心	lose heart
失去作用	out of action
失去理智了	out of one's mind
失去聯繫	lose touch
失去聯繫	out of touch
失去臉	loss of face
失去襯衫	lose one's shirt
失去計數	lose count
失去門票	lose a wicket
失去陰謀	lose the plot
失去靈魂	lost soul
失控	out of control
失明	blindness
夾住翅膀	clip the wings of
夾具	gripper
夾具起來了	the jig is up
奇怪	oddly
奇怪	oddness
奇怪	strangely
套期保值者	hedger
奮鬥者	struggler
女巫小時	the witching hour
奶酪吧！	cheese it!
她在室內	her indoors
她很甜蜜	she's sweet
她是蘋果	she's apples
好一個	nice one
好久不見	long time no see
好大	whacker
好奇心殺死了貓	curiosity killed the cat
好好地活著	alive and well
好工作	nice work
好幾個	a good few
好心人	wisher
好書	the Good Book
好歡呼	of good cheer
好歹	at any rate
好漂亮	cor blimey
好玩的數字	figure of fun
好的工作，如果你能得到它	nice work if you can get it
好的折扣	a great deal
好的措施	for good measure
好錢	good money
如	such as
如何！	and how!
如果	what if
如果不	if not
如果不破壞，不要修復它	if it ain't broke, don't fix it
如果你不能打敗他們，加入他們	if you can't beat them, join them
如果你問我	if you ask me
如果你喜歡	if you like
如果你能夠	if you please
如果你願意	if you will
如果只有	if and only if
如果和當時	if and when
如果我是你	if I were you
如果是這樣	if so
如果有什麼	if anything
如果需要的話	if need be
如果鞋子適合，穿它	if the shoe fits, wear it
如此	so much as
如此這般	such-and-such
如火如荼	in full swing
如融化	meltingly
妄想	delusional
妻子的	wifely
姓名	name names
委託人	truster
媽媽媽媽	Lady Muck
媽媽的話	mum's the word
嬌滴滴	prettily
嬰兒期	babyhood
字裡行間	read between the lines
存在心靈	presence of mind
存款	on deposit
存活性	aliveness
季節的問候	season's greetings
孤兒	fatherless
孤注一擲	go for broke
孤獨	aloneness
孤獨感	lonesomeness
孩子的戲	child's play
學校硬敲門	the school of hard knocks
學派	school of thought
它不在	it's not on
它不會做	it won't do
它可以	can it
它可作用	actable
它沒有下雨，但它倒了	it never rains but it pours
它沒有任何可能	it makes no odds
它沒有完成	it isn't done
守口如瓶	lipped
守衛	off guard
守衛	under guard
安全	securely
安全的知識	safe in the knowledge that
安全第一	safety first
安然	safely
安裝	mountable
宋詞夢幻	illusional
完全哭泣	in full cry
完成	finish with
完美	to perfection
定價者	pricer
定標器	scaler
宜早不宜遲	sooner rather than later
宣傳員	plugger
宣示	declaratory
家，甜蜜的家	home sweet home
家是心之所在	home is where the heart is
容易	easiness
容易的美德	of easy virtue
容易的肉	easy meat
寂靜	quietness
寂靜	stillness
寄件人	sender
密切	closely
密封	sealable
富豪	spender
寒冷	chillness
寒冷	coldness
寒冷的	chillsome
實力塔	tower of strength
實物	in kind
實質上	in substance
實踐完美	practice makes perfect
實踐者	practiser
實際上	in actual fact
實體性	solidness
寧願	had rather
寫在石頭上	be written in stone
寬恕	forgiver
寶貝在懷裡	babe in arms
寶貝在樹林裡	babe in the woods
寸草不生	grassless
封閉的書	closed book
射一條線	shoot a line
射出來	shoot it out
射擊	shoot through
射擊	shoot up
射擊線	the firing line
將...拋開;將...扔掉	throw something away
將男人與男孩分開	separate the men from the boys
將羊與山羊分開	separate the sheep from the goats
將輪子置於運動狀態	set the wheels in motion
尋求	to seek
對上帝	to God
對不起自己	sorry for oneself
對接	butt in
對接頭	butt heads
對於其餘的	for the rest
對於初學者	for starters
對於某些	for certain
對於這個問題	for that matter
對於隨機數	for the nonce
對毒品	on drugs
對沖下注	hedge one's bets
對病人	on the sick
對的東西	the right stuff
對立	oppositional
對股票	on the stocks
對面	across from
導引頭	seeker
導致	lead up to
小便在風中	piss in the wind
小包裡的小丑	the joker in the pack
小土豆	small potatoes
小型炸彈	bomblet
小奇蹟	small wonder
小女人	the little woman
小屏幕	the small screen
小心	look out
小心點	have a care
小或沒有	little or nothing
小指	pinky
小是美麗的	small is beautiful
小洞不補，大洞吃苦	a stitch in time saves nine
小溪	streamlet
小的背部	the small of the back
小豬	pigling
少即是多	less is more
少得多	much less
少量地	sparely
尖端	the sharp end
尖銳的	sharp as a tack
尤其是	in particular
就事論事，實事求是地	matter-of-factly
就像	as was
就像是	something like
就像死了一樣	as near as damn it
就在	just on
就在	right on
就是這個	this is it
就是這樣	that's that
就這樣	as it stands
就這樣	be the case
就這樣	just as well
就這樣	just so
就這樣	like so
就這樣	such that
就這樣吧	so be it
就這麼多	just so much
就這麼說定咯	it's a deal
尾	tailed
尾巴回來	tail back
屁股	butt out
屁股超過山雀	arse over tit
屁股關於臉	arse about face
屋子	roomful
展出	on show
展望未來	look to the future
展現出	show out
山中腹地	mountainy
山那邊	over the hill
崩潰	melt down
崩解	break off
巡航瘀傷	cruising for a bruising
工作中	at work
工作之間	between jobs
工匠	tinkerer
巧妙	cleverly
巧妙	smartly
已出版	in print
已經在周圍	have been around
已經有了	have had it
已經看到了這一切	have seen it all before
布丁的證據是在吃飯	the proof of the pudding is in the eating
布朗尼點	brownie point
布瑟	busser
布的人	man of the cloth
布穀在巢裡	cuckoo in the nest
布雷茲札克	biter
希弗	heaver
希望反對希望	hope against hope
希望最好的	hope for the best
帥	handsomeness
帥帥帥	handsome is as handsome does
帳單和coo	bill and coo
帳戶	account for
帶一個人	take someone in
帶個人出去	take someone out
帶刺	thorned
帶去	take to
帶回來	bring something back
帶回家培根	bring home the bacon
帶蓋	lidded
帶走	take away from
帶走一個人	take someone off
帶走別人的呼吸	take someone's breath away
帶路	lead the way
帶領	take the field
帶領一個人	lead someone on
帶點東西	bring something in
帶點東西	bring something to
常見的。。	the common weal
常見的形式	common form
常見的觸摸	the common touch
常識	common knowledge
帽子在手	hat in hand
幕後	behind the scenes
幫助	in aid of
幫某人一個忙	do someone a favour
干擾	jammer
平凡	ordinariness
平均休息	an even break
平均生意	mean business
平均街道	mean streets
平心靜氣	calmly
平整	flat out
平整度	flatness
平方	square up
平方英尺	square off
平淡如日	plain as day
平等	on equal terms
平衡器	balancer
幸福	blissfully
幸福的無知	blissful ignorance
幸運女神	Lady Luck
幽靈般的	ghostlike
幽默感	sense of humour
幾乎沒有	hardly any
幾乎沒有	hardly ever
幾個	some few
幾個和很遠之間	few and far between
幾個小時後	after hours
幾句話	of few words
床前禮儀	bedside manner
序幕	raiser
廉價	cheapness
廉價地	cheaply
廢話	waste words
廢除	do away with
廣大	largeness
建國	nationhood
建在沙灘上	built on sand
建房子	set up house
建橋	build bridges
弄亂了一些東西	mess something up
弄亂了一個人	mess someone up
弄濕寶寶的頭	wet the baby's head
引導	bootstrapping
引導泵	prime the pump
引用	referrer
引過來	draw in
弦	string-like
弦	stringless
張大	wide open
張貼	post up
張開嘴	open one's mouth
張開雙臂	with open arms
強壯	strong on
強硬	toughly
強迫步伐	force the pace
彈出	pop up
彈出問題	pop the question
彈道	ballistically
彌補	fetch up
彌補	make up to
彌補地面	make up ground
彌補失去的時間	make up for lost time
彌補自己的心靈	make up one's mind
彎曲	bendable
彎曲的形狀	bent out of shape
影響者	influencer
彷彿！	as if!
往往不是	more often than not
很久以前	once upon a time
很值得	well worth
很公平	fair enough
很可能沒有	as likely as not
很好	be well out of
很好	mean well
很好	very well
很容易	have it easy
很少幾個	quite a few
很遠了	far gone
很難做到	hard done by
很難在	hard at it
很難聽清	hard of hearing
很難過	hard going
很高興見到你	nice to meet you
很高興見到你	pleased to meet you
徒勞的	vainly
徒步旅行者	hiker
徒然	in vain
得分	score points
得分點數	score points off
得到	get at
得到	get by
得到一些東西	get something going
得到一些東西	get something out
得到一些東西	get something out of
得到一些東西	get something over
得到一些東西	get something over with
得到一些東西	get something up
得到一些直線	get something straight
得到一個人生	get a life
得到一個修復	get a fix on
得到一個動作	get a move on
得到一個負載	get a load of
得到一條線	get a line on
得到地獄	get hell
得到外面	get outside of
得到它	get it on
得到宗教信仰	get religion
得到幫助	be of assistance
得到更好的	get the better of
得到最好的	get the best of
得到某人的神經	get on someone's nerves
得到消息	get the message
得到照片	get the picture
得到的	get the hang of
得到真正的！	get real!
得到程序	get with the program
得到行動和去	get-up-and-go
得到開機	get the boot
得到頂部	get on top of
得到風	get wind of
得到鳥	get the bird
從A到B	from A to B
從A到Z	from A to Z
從一個孩子	from a child
從一邊到另一邊	from side to side
從一開始	from the top
從上到下	from top to bottom
從上到下	from top to toe
從上面	from above
從下到上	from the bottom up
從不停止	never cease to
從來不會吐吐滿足	never the twain shall meet
從來沒有一個	never a one
從力量	from strength
從口袋裡掏出	out of pocket
從各個角度	from all angles
從同一塊布上切下來	cut from the same cloth
從單詞go	from the word go
從地板上	from the floor
從壞到壞	from bad to worse
從大自然	from nature
從天上的便士	pennies from heaven
從容應對	roll with the punches
從封面到封面	from cover to cover
從心裡哭泣	cry from the heart
從我那裡拿走	take it from me
從木工出來	come out of the woodwork
從柱到柱	from pillar to post
從桿到船尾	from stem to stern
從死裡復活	from the dead
從第一天開始	from day one
從而掛起故事	thereby hangs a tale
從臀部拍攝	shoot from the hip
從記憶裡	from memory
從過去的爆炸	a blast from the past
從長遠來看	in the long run
從頭到尾	from first to last
從頭開始	from scratch
從頭開始	from the ground up
從馬的嘴裡	from the horse's mouth
從高處	from on high
復仇	with a vengeance
復仇者	revenger
循環	loop the loop
微妙	delicately
微甜	sweetish
徹頭徹尾	through and through
心和花	hearts and flowers
心對心	heart to heart
心態	frame of mind
心胸	souled
心靈不健全	of unsound mind
心靈與心靈	hearts and minds
必要性是發明之母	necessity is the mother of invention
忍了下來	bear down
忍住了	put up with
忍受	bear with
忙起來	get busy
忠於	string along
快到家了	close to home
快樂	take pleasure in
快樂好	jolly well
快樂的狩獵場	happy hunting ground
快速畫畫	quick on the draw
快速骯髒	quick and dirty
怎麼了	what of it?
怎麼了	what's what
怎麼來的？	how come?
怎麼和為什麼	the how and why
怎麼會這樣？	how so?
怎麼樣	how about
怎麼樣	how now?
怎麼樣？	how's that?
性較弱	the weaker sex
恐怕	I'm afraid
恐慌	panicky
恩典的狀態	state of grace
恩典的行為	act of grace
恰好	fitly
患者	sufferer
情境	situational
情由	rhyme or reason
惡	badness
惡人不休息	no rest for the wicked
惡人沒有和平	no peace for the wicked
惡毒地	blackly
想出來	come up with
想大	think big
想想	think on
想賭？	want to bet?
意味深長	meaningly
意圖	with intent
意外地	by accident
意外地意外	accidentally on purpose
意思是說	mean to say
意見分歧	difference of opinion
意願	volitional
愚蠢的運氣	dumb luck
愛上	fall for
愛情	for love
愛的勞動	a labour of love
感受到脈搏	feel the pulse of
感興趣	at interest
感興趣	with interest
感覺好因素	feel-good factor
感覺很小	feel small
感覺捏	feel the pinch
感謝上帝	thank God
慈善活動從家裡開始	charity begins at home
慘淡經營	dismally
慢慢肯定地	slowly but surely
慢燒	a slow burn
慷慨的希望	forlorn hope
憂	lose sleep
憋	hold back
憐憫	at the mercy of
懂行	know the ropes
懇求	cop a plea
應變的	strainable
應驗	come to pass
懷疑	in doubt
懷疑	under suspicion
懷疑的好處	the benefit of the doubt
成串	bunchy
成兩半	in two
成品	the finished article
成型	formable
成幀器	framer
成形	shaped
成形	take shape
成為	be of
成為一個醒來	be a wake-up
成為一群	be a mass of
成為受害者	fall victim to
成為小狗	be up shit creek
成為最多	be the most
成為最好的朋友	be the best of friends
成為獵物	fall prey to
成真	come true
成色	fineness
成長出來	grow out of
我不應該想	I shouldn't wonder
我不會知道	I wouldn't know
我不會說不	I wouldn't say no
我們中的一員	one of us
我們到了	here we are
我們會看到這個	we'll see about that
我們的主	Our Lord
我們的孩子	our kid
我和我的	me and mine
我喜歡！	I like that!
我學到的朋友	my learned friend
我很容易	I'm easy
我必須說	I must say
我想是這樣	I suppose so
我會吃我的帽子	I'll eat my hat
我會喝酒	I'll drink to that
我會說	I'll say
我沒事，傑克	I'm all right, Jack
我的主	My Lord
我的女士	My Lady
我的好女人	my good woman
我的意思是	I mean
我的星星！	my stars!
我的榮幸	my pleasure
我的腳！	my foot!
我的誓言	my oath
我的錯	my bad
我知道	I know
我自己	by myself
我說！	I say!
我贏了，你失去了尾巴	heads I win, tails you lose
我顫抖地想	I shudder to think
戒斷症狀	withdrawal symptoms
或任何地方	or wherever
或任何時候	or whenever
或任何東西	or anything
或多或少	more or less
或更糟	or worse
或沒有	or no
或者	or so
或者其他的東西	or something
截肢	limbless
戰場	battle stations
戰爭狀態	state of war
戰爭的狗	the dogs of war
戰爭的藝術	the art of war
戰爭結束所有的戰爭	war to end all wars
戰鬥了	battle it out
戰鬥或逃跑	fight or flight
戰鬥皇室	battle royal
戴帽子	hatless
戴手套	gloved
房子前方	front of house
房子和家	house and home
房子的人	man of the house
所以在那裡	so there
所有 - 	all that - 
所有 - 	all too - 
所有和雜項	all and sundry
所有在一天的工作	all in a day's work
所有投注都關閉	all bets are off
所有的	all of
所有的	all there
所有的	be all that
所有的	sod all
所有的人	all comers
所有的冰雹	all hail
所有的小時	all hours
所有的情況都被考慮到了	all things considered
所有的手在甲板上	all hands on deck
所有的槍支燃燒	with all guns blazing
所有的顫抖	all of a tremble
所有肉體	all flesh
所有船上！	all aboard!
所有閃光的不都是金子	all that glitters is not gold
扇形	fan-like
手	sleight of hand
手	to hand
手上	on hand
手套手套	hand in glove
手挽手	arm in arm
手牽手	hand in hand
手腕上的一聲	a slap on the wrist
手銬	cuffed
扎進	tie into
扒開	clawed
打一個	tie one on
打一個洞	make a hole in
打一場戰鬥	make a fight of it
打下來	beat down
打乾草	hit the hay
打了	hit on
打了它	hit it off
打了小姐	hit-and-miss
打了就跑	hit-and-run
打了標記	hit the mark
打了路	hit the road
打人了	beat someone up
打人了	hit someone up
打個招呼	make a hit
打個招手	turn a trick
打倒了	whack off
打包	pack it in
打印字	the printed word
打右鍵	hit the right note
打和弦	strike a chord
打噴嚏	sneezer
打噴嚏	sneezy
打在頭上的釘子	hit the nail on the head
打扮	dress up
打擾一下	excuse me
打擾我	bugger me
打擾蘋果車	upset the apple cart
打敗了	beat off
打敗失敗的戰鬥	fight a losing battle
打敗樂隊	to beat the band
打敗褲子	beat the pants off
打架了	put up a fight
打滑板	hit the skids
打球	play ball
打瓶子	hit the bottle
打瞌睡	nod off
打破	break in
打破一些東西	break something down
打破一些東西	break something in
打破一步	break step
打破兩個	break in two
打破冰塊	break the ice
打破地面	break ground
打破某人的心臟	break someone's heart
打破模具	break the mould
打破背後	break the back of
打破銀行	break the bank
打破鴨子	break one's duck
打破麵包	break bread
打結	get knotted
打結	knotter
打結	tie the knot
打者	hitter
打蛋器	whipper
打賭農場	bet the farm
打通	get through
打鐘	beat the clock
打開	open up
打開	turn on
打開東西	turn something on
打開起落架	gear down
打開門	open the door to
打開魅力	turn on the charm
打電話	call on
打電話給別人	call someone up
打電話給某人	call someone in
打電話給某人	call someone out
打電話給武器	a call to arms
打黃金	strike gold
打齒和釘子	fight tooth and nail
扔掉	throw off
扔東西	throw something in
扔東西	throw something out
扔東西	throw something up
扔錢	throw money at
扭轉	round the twist
扳手在作品中	spanner in the works
找上帝	find God
找人出來	find someone out
找到好處	find favour
找時間	make time
找那位女士	find the lady
找麻煩	look for trouble
承受	bear off
承受	bear on
承受壓力	bear down on
承擔	take on
承擔責任	bear the burden of
承諾	on a promise
承諾，承諾	promises, promises
把一個人的玩具從嬰兒車里扔出來	throw one's toys out of the pram
把人帶走	bring someone down
把人推到牆上	drive someone up the wall
把光芒關掉	take the shine off
把兩個和兩個放在一起	put two and two together
把咬了	put the bite on
把它拿出來	take it out of
把它放在下巴上	take it on the chin
把它放在你的管道裡並吸煙	put that in your pipe and smoke it
把它放在那裡	put it there
把它關掉	knock it off
把房子拉下來	bring the house down
把手形	knobbed
把手放下	hands down
把手放在上面	put the arm on
把手轉過來	turn one's hand to
把書扔了	throw the book at
把東西向前	put something forward
把東西拿出來	put something out
把東西提升到一個新的水平	take something to the next level
把東西放回來	put something back
把東西放在一起	put something together
把東西放開	put something away
把某人下來	pin someone down
把某人帶到	put someone to
把某人恥辱	put someone to shame
把某人搞砸了	screw someone up
把某人放下	put someone down
把某人放下	put someone down for
把某人放在	put someone on
把某人當場	put someone on the spot
把某人翻過來	screw someone over
把某人降下來	turn someone down
把棍子	up the stick
把碎片撿起來	pick up the pieces
把腳抬起來	put one's feet up
把腳放下	put one's foot down
把貓從包裡拿出來	let the cat out of the bag
把錢遞過去	pass the buck
把門關了	blow the doors off
把頭埋在沙灘上	bury one's head in the sand
把馬車放在馬前	put the cart before the horse
抒情	lyrically
抓住一隻手	clasp one's hands
抓住稻草	grasp at straws
抓住蕁麻	grasp the nettle
抓手	grasper
抓蟹	catch a crab
抓起來	up for grabs
投了很多	cast lots
投光燈	cast light on
投擲者	chucker
投放	put in
投標	tenderer
投毒	poisoner
投身於	dive into
折扣	at a discount
折角下降	knuckle down
折騰的人	tossing the caber
折騰餅乾	toss one's cookies
抬起屋頂	raise the roof
抬起後方	bring up the rear
抬起頭	head up
抬頭	gain ground
抬頭	look up
抬高	jack up
抱	armful
抱住某人下來	hold someone down
抱著自己的馬	hold one's horses
抵押人	pledger
抹除	wipe out
押	chargee
抽獎運氣	the luck of the draw
抽籤	draw lots
抽血	draw blood
抽象地	abstractly
拆東牆補西牆	rob Peter to pay Paul
拉bon	pull a boner
拉一些東西	pull something off
拉一個人	pull someone over
拉一個快一個	pull a fast one
拉什	rusher
拉入	pull in
拉出所有的停靠點	pull out all the stops
拉回來	draw back
拉弦	pull strings
拉弦	pull the strings
拉某人的腿	pull someone's leg
拉等級	pull rank
拉起	pull up
拉起股權	pull up stakes
拉過來	pull over
拋出	throwable
拋出一個人	throw someone out
拋錨	drop anchor
拍打背後的人	slap someone on the back
拍拍眼睛	clap eyes on
拔出	pull out
拔插頭	pull the plug
拖了	haul off
拖屁股	haul ass
拖延	drag on
拖延是時間的小偷	procrastination is the thief of time
拖拉	tugger
拖放	drag and drop
拖曳腳	drag one's feet
拖著	in tow
拘謹的	squarish
拯救	deliverer
拯救某人的生命	save someone's life
拼湊的	discordantly
拿一些東西	take something in
拿一些東西	take something over
拿五個	take five
拿公牛拿角	take the bull by the horns
拿出一些東西	take something out
拿回來	take something back
拿土墩	take the mound
拿數	take the count
拿某人	take someone on
拿水	hold water
拿空氣	take the air
拿第五	take the fifth
拿粉	take a powder
拿股票	take stock
拿自由	take liberties
拿著它！	take that!
拿著所有的卡	hold all the cards
拿蓋子	take cover
拿蛋糕	take the cake
拿走	take after
拿走東西	take something away
拿起來	get it up
拿起來	pick up after
拿起手臂	take up arms
拿起東西	take something up
拿起標籤	pick up the tab
持平	flattish
持有	hold with
持續時間	for the duration
指出一點	point something out
指甲床	bed of nails
指著手指	point the finger
指關節下	knuckle under
按下按鈕	press the button
按名字	by name
按命令	by order
按摩器	massager
按數字	by numbers
按比例	in proportion
按毛額	by the gross
按照	as per
按照定義	by definition
按照慣例	as per usual
按理說	it stands to reason
按耐不住	fly off the handle
按規則	by rule
按規則玩	play by the rules
按計劃去	go according to plan
按門鈴	ring a bell
按順序	on the order of
挑一個鎖	pick a lock
挑尼斯	pick nits
挑撥	play off
挑選	pick and choose
挖深	dig deep
挨打	take a beating
挫	lower the tone
挺舉	clean and jerk
捆綁	bundler
捕捉器	capturer
捲入	roll in
捲成一體	rolled into one
捲揚機	hoister
捲起	roll up
捻接器	splicer
授予者	granter
掉出來	fall out
掉進	drop into
掊擊	lash out
掌	palmar
掌控之中	in control
掌握之中	under control
掏	draw out
排他性	exclusionary
排序	sortable
排扣	breasted
排除在外	to the exclusion of
排除某人	sort someone out
掙脫	break free
掛十	hang ten
掛回	hang back
掛在	hang in
掛在一起	hang together
掛在空中	hang in the air
掛斷	hang up
掛斷電話	ring off
掛線	hang by a thread
掛起來	hang loose
掛起火	hang fire
掛鉤	hook up
採取一切	take sides
採取措施	take measures
採取翼	take wing
採取行動	go into action
採取行動	make a move
採取行動	put into action
採取行動	take action
採取說唱	take the rap
採取長視野	take the long view
採集	gatherer
採集卡	grabber
探查	profiler
接上	pick on
接下來是什麼	what next
接著	now then
接著就，隨即	with that
接近	closer
接近	come close
接連	in succession to
控制	get a grip
推入	push in
推時推	when push comes to shove
推理	reasoner
推進	advancer
推進	push ahead
推進	push on
推遲	push off
揀選	pickable
揉搓	rub along
提供證據	give evidence
提出一個問題	make an issue of
提出一點	make a point of
提出這個問題	beg the question
提出這個問題	put the question
提前	in advance
提前時間	ahead of time
提前的	in advance of
提取程序	fetcher
提議者	proposer
提高地獄	raise hell
插上一些東西	jack something up
插入	plug into
插入東西	plug something in
插隊	cut in line
換一個	for a change
換一種說法	in other words
換一邊	change sides
換上	change up
換了	change over
換手	change hands
換砂	shifting sands
握住東西	hold something in
握住某人的手	hold someone's hand
握住線	hold the line
握住首頁	hold the front page
握手	hold hands
握手	take a hand
援助和慫恿	aid and abet
損壞了	the damage is done
搖一個人	shake someone up
搖一搖	shake on
搖一搖	shake one's booty
搖一搖	shake something out
搖一腿	shake a leg
搖下來	shake down
搖了搖頭	rock up
搖滾	rock out
搖滾船	rock the boat
搖頭	shake one's head
搜索	searcher
搞亂	mess up
搞什麼鬼	what the hell
搞定	buttoned
搦	take hold
搧風機	fanner
搬入	move in
搬弄是非	tell tales
搭乘飛機	take flight
搶白	dress down
摔倒	fall down
摔平	fall flat
撐起來	bear up
撕成	rip into
撕成	tear into
撕掉一些東西	rip something off
撕掉一個人	rip someone off
撕裂樣	tear-like
撞上地面跑步	hit the ground running
撞下艙口	batten down the hatches
撞牆	hit the wall
播出	play out
撲滅	put out
撿起	pick up
撿起某物	pick something up
擁有一切	have everything
擊中了	hit the spot
擊中或沒打中	hit-or-miss
擊劍運動員	fencer
擊敗系統	beat the system
擊敗說唱	beat the rap
擊鎚	hammerless
擋住	keep off
據，直到...為止	as far as
據我所見	as far as I can see
擠壓	squeezable
擠壓了	put the squeeze on
擦拭石板乾淨	wipe the slate clean
擦掉	rub off
擦肩膀	rub shoulders with
擦鼻子	rub noses
擰上一些東西	screw something up
擰上螺絲	put the screws on
擰緊	screw up
擺脫	break away
擺脫	get rid of
擺脫傷害的方式	out of harm's way
擺龍門陣	spin a yarn
攜帶一天	carry the day
攜帶重量	carry weight
支持	stand by
支撐自己的東西	strut one's stuff
收工	knock off
收拾	clear up
收拾屋子	clean house
收支平衡	break even
收費	chargeable
收起來	stow away
改變一個人的想法	change one's mind
改變主題	change the subject
改變地方	change places
改變心臟	a change of heart
改變步伐	change of pace
改變變化	ring the changes
改變顏色	change colour
改過自新	turn over a new leaf
攻擊性	offensiveness
放一下	put one over on
放一些東西	lay something on
放一些東西	lay something out
放一些東西	put something off
放一些東西	put something on
放一些東西	put something to
放一些東西	put something up
放一個價錢	put a price on
放一個比賽	put a match to
放一個阻尼器	put a damper on
放一個雞蛋	lay an egg
放上	put up
放下	drop off
放下	lay up
放下	let up
放下	peed off
放下一些東西	lay something down
放下一些東西	lay something off
放下一個人	lay someone out
放下東西	put something down
放下根	put down roots
放下頭髮	let one's hair down
放了	put about
放人吧	put someone up
放個名字	put a name to
放出	give out
放出	let out
放在一邊	step aside
放在劍上	put to the sword
放在線上	lay it on the line
放在麗思	put on the ritz
放屁	break wind
放心	in relief
放手	hands off
放手	let on
放棄	give it up
放棄	give up
放棄	give up on
放棄鬼魂	give up the ghost
放火者	firer
放腳	put foot
放開一些東西	let something off
放開蒸汽	let off steam
放風箏	fly a kite
放鬆	loosen up
故事發生	the story goes
故事結局	end of story
故意	on purpose
故鄉	oldness
敏銳地	keenly
救濟	on relief
教一個人一課	teach someone a lesson
教學校	teach school
散裝	in bulk
敲一下東西	knock something off
敲一個人	knock someone off
敲一個人	knock someone over
敲一個人	knock someone up
敲一個人出來	knock someone out
敲下底	knock the bottom out of
敲出一些東西	knock something out
敲木頭	knock on wood
敲襪子	knock the socks off
敲門	knock on
敲門	knock up
整個enchilada	the whole enchilada
整個九碼	the whole nine yards
整個展會	all over the show
整個蠟球	the whole ball of wax
整形	shaper
整體性	wholeness
數字	figure on
文件管理器	filer
文字戰爭	war of words
文學家	man of letters
文筆比刀劍更有力	the pen is mightier than the sword
料斗中	hoper
斯托勒	storer
斯林格	slinger
斯泰勒	styler
斯皮勒	spiller
新奇	newness
新年	New Year's
新望	newish
新的小孩在街上	the new kid on the block
新的正常	the new normal
新的黑色	the new black
新約	New Covenant
新聞收費	press charges
新鮮	freshness
新鮮出來	be fresh out of
新鮮血液	fresh blood
斷斷續續地	off and on
方向感	sense of direction
方式去！	way to go!
方式方法	ways and means
方面的矛盾	contradiction in terms
旁觀	look on
旁觀者	stander
旁邊的	next to
旁邊自己	beside oneself
旅行燈	travel light
旅行燈光太棒了	trip the light fantastic
旋弄	twiddler
旋鈕式	knob-like
日夜	day and night
日常生活	daily life
日復一日	day after day
日復一日	day by day
日日夜夜	night and day
日漸疏遠	grow apart
早上，中午，晚上	morning, noon, and night
早些時候	back in the day
早期的門	early doors
早熟	earliness
早起	the early hours
早起的鳥兒	early bird
昂貴地	preciously
明亮地	brightly
明亮早	bright and early
明亮的燈光	bright lights
明亮的眼睛和濃密的尾巴	bright-eyed and bushy-tailed
明天又是新的一天	tomorrow is another day
明智	wisely
明白地	plainly
昏暗的	dullish
易碎	crispness
星象	starlike
映射器	mapper
春天洩漏	spring a leak
是什麼賦予了？	what gives?
是任何人的	be anyone's
是因為它可能	be that as it may
是地獄	be hell on
是有機會	stand a chance
是極限	be the limit
是歷史	be history
是死亡	be the death of
是門票	be tickets
時	from time to time
時代的標誌	sign of the times
時間不在意	time out of mind
時間到了	time was
時間就是金錢	time is money
時間遠古	time immemorial
晶	grained
晶瑩剔透	crystal clear
暈眩	giddily
暖身	warm up
暗淡	dimness
暗示	by implication
暫且	for the time being
暫停	hold off
暫停懷疑	suspend disbelief
暫停服務	out of service
暫時	for the moment
暴動	run riot
暴風雨前的平靜	the calm before the storm
更	what is more
更何況	not to mention
更像	more like
更別提	let alone
更可惜	more's the pity
更喜歡它	more like it
更好的	better off
更好的捕鼠器	a better mousetrap
更好的部分	the better part of
更精細的點	the finer points of
更糟糕的是磨損	the worse for wear
書中最古老的伎倆	the oldest trick in the book
書中的每一招	every trick in the book
曾經在一個藍色的月亮	once in a blue moon
最下面	bottommost
最低的低點	the lowest of the low
最佳品種	best of breed
最先進的	state of the art
最古老的職業	the oldest profession
最喜歡的兒子	favourite son
最多	at most
最大的份額	the lion's share
最好	at best
最好不好	up to no good
最好做點什麼	had better do something
最好的	second to none
最好的	with the best of them
最好的朋友	one's best friend
最好的祝愿	best wishes
最好的部分	the best part of
最弱的環節	the weakest link
最後	at last
最後	at length
最後一件事	last thing
最後一個字	the last word
最後一分鐘	the last minute
最後一根稻草	the last straw
最後但並非最不重要的	last but not least
最後的稻草	the final straw
最後笑了	have the last laugh
最新的	at the latest
最終證明了手段	the end justifies the means
最近	of late
最遠的	at the furthest
會做	will do
會有地獄要付錢	there will be hell to pay
會期	sessional
會發生	give rise to
月亮中的男人	the man in the moon
月黑風高	moonless
有一件事情	have a thing about
有一個去	have a go at
有一個太多了	have one too many
有一個字	have a word
有一個想法	spare a thought for
有一個時間的鯨魚	have a whale of a time
有一個爆炸聲	with a bang
有一個線索	have a clue
有一個顛簸	with a bump
有一刻	have a moment
有一定風險	at risk
有一種方式	have one's way with
有一隻眼睛	with one eye on
有一隻鳥	have a bird
有一頭牛	have a cow
有一顆心	have a heart
有一顆金子的心	have a heart of gold
有下降	have the drop on
有了	have at
有事情了	something is up
有些	somewhat of
有人上	have someone on
有人離開	piss someone off
有什麼可能性？	what's the odds?
有什麼需要	have what it takes
有偏見	with prejudice
有優勢	have the advantage of
有兩個左腳	have two left feet
有兩種方式	have it both ways
有共同之處	have something in common
有利可圖	at a profit
有利於	to advantage
有區別	with a difference
有可能和主要	with might and main
有問題	come into question
有問題	have a problem with
有問題	in question
有好處的朋友	friend with benefits
有存貨	in store
有它	have it
有小貓	have kittens
有幾個	have a few
有意志	with a will
有意義	make sense of
有效	in effect
有效	usefully
有效	with effect from
有時	at times
有時間	have the time
有更好的	have the better of
有東西要提供	have something to offer
有機會有它	as chance would have it
有熱的	have the hots for
有特殊風格的	characterful
有球	have a ball
有眼睛	have an eye for
有神力的鋼鐵	have nerves of steel
有螺絲鬆動	have a screw loose
有血有肉	flesh and blood
有規律的	like clockwork
有設計	have designs on
有證據	in evidence
有趣	interestingly
有趣和遊戲	fun and games
有辦法	have a way with
有這麼多話	in so many words
有過錯	at fault
有錢能使鬼推磨	money talks
有鎖	have a lock on
有鐘聲	with bells on
有需要	had need
有風險	at risk to
有點	kind of
有點	sort of
有點厚	a bit thick
有點多	a bit much
有點小	some little
有點粗糙	bit of rough
朋友在高處	friends in high places
服務	be of service
服務兩位大師	serve two masters
朗伯	lamber
朗讀	speakable
朝前	frontwards
朝天	heavenward
期待	look forward to
未敢苟同	beg to differ
未知的	unknown to
本地	natively
本身就是目的	an end in itself
朵朵	stemmed
杜絕	put an end to
束帶	belted
束縛在	bound up in
板球	cricketing
果然	expectedly
果然	sure enough
果然不出所料	on cue
枯萎在藤蔓上	wither on the vine
架狀	shelf-like
某事或其他	something or other
某種東西	something of the kind
染上羊毛	dyed in the wool
柔軟度	softness
查看	check out
查看	viewable
柱撐	pillared
根深蒂固	rootedness
根狀	root-like
桃子和奶油	peaches and cream
條件是	on condition that
條款	on terms
條狀	sticklike
棄權	renounceable
棄船	abandon ship
棒狀	rod-like
棒的短端	the short end of the stick
楔的末端	thin end of the wedge
楔的薄端	the thin end of the wedge
榮幸	with pleasure
榮耀	to glory
榮耀的榮耀	crowning glory
榮譽之人	man of honour
槍殺	gunned
槍的兒子	son of a gun
槳手	paddler
標準地	standardly
標記你	mark you
標記時間	mark time
模具是鑄造的	the die is cast
模糊	faintness
樹根	rooty
樹狀	tree-like
樹的頂部	the top of the tree
橋接	bridgeable
機不可失，時不再來	now or never
機會之窗	window of opportunity
機會敲門	opportunity knocks
機靈	smartness
橡木	oaken
橡木	oaky
橫過腿	cross one's legs
檢查	check into
檢查	check on
檢查	check through
檢查	check up on
檢舉人	flagger
櫃子	forcer
權力分立	separation of powers
權力是	the powers that be
權力背後的王位	power behind the throne
欺騙	lie to
歡樂	gladness
歡迎者	welcomer
正在促銷	on offer
正在進行中	in the process
正當性	rightness
正直	plainness
此外	in addition
此時此地	here and now
步行恥辱	walk of shame
步行的	walkable
步行的生活	walk of life
武者回歸	returner
武裝到牙齒	armed to the teeth
歸結為	come down to
死一般	deathlike
死了	dead on
死了世界	dead to the world
死亡	to death
死亡之吻	kiss of death
死亡和埋葬	dead and buried
死人的夜晚	the dead of night
死在床上	die in bed
死在水里	dead in the water
死在藤上	die on the vine
死硬死硬的頑固的	die hard
死神者	the Grim Reaper
死緩	stay of execution
死肉	dead meat
殘酷	cruelly
殘酷和不尋常的懲罰	cruel and unusual punishment
殺人	make a killing
殺死或治愈	kill or cure
殺死肥胖的小腿	kill the fatted calf
毆打別人	beat someone down
每一個	each and every
每一寸	every inch
每一秒	every second
每一種方式	every which way
每一隻手	on every hand
每一點	every bit as
每個白領	every whit
每個角落和骷髏	every nook and cranny
每天五點	five a day
每幾個	every few
每時每刻	all the time
每次	every time
每隔一段時間	every so often
比...好	better than
比例感	sense of proportion
比對不起安全	better safe than sorry
比活著還要死	more dead than alive
比生命更大	larger than life
比白色更白	whiter than white
比賽時間	a race against time
比賽的人	man of the match
比較筆記	compare notes
毛皮和羽毛	fur and feather
毛糙	raggedness
毛羽	hairiness
毛髮狀	hair-like
毫不費力	without fail
毫無作用	like water off a duck's back
毫無例外	without exception
毫無疑問	beyond doubt
毫無疑問	no doubt
氣短	short of breath
氣絕	kick the bucket
水從鴨子的背上掉下來	water off a duck's back
水瓶座的時代	Age of Aquarius
永不言敗	never say die
永恆的三角形	eternal triangle
永恆的生命	eternal life
永遠	for ever
永遠不要害怕	never fear
永遠和anon	ever and anon
汗水子彈	sweat bullets
汗水小東西	sweat the small stuff
汗血	sweat blood
沉重	heaviness
沉默是金	silence is golden
沉默的大多數	the silent majority
沉默的待遇	the silent treatment
沒什麼	come to nothing
沒什麼	no nothing
沒什麼	nothing much
沒問題	no problem
沒地方	no place
沒好氣	snappily
沒心情	out of sorts
沒時間	no time
沒有	do without
沒有一個免費的午餐	there's no such thing as a free lunch
沒有一點	no little
沒有不確定的條件	in no uncertain terms
沒有什麼	nothing of the sort
沒有什麼可失去的	have nothing to lose
沒有什麼樣的	nothing of the kind
沒有什麼比	nothing less than
沒有任何東西	leave no stone unturned
沒有任何附加條件	no strings attached
沒有停止	stop at nothing
沒有傷害	come to no harm
沒有傷害	no harm done
沒有傻子像一個老傻瓜	there's no fool like an old fool
沒有儀式	without ceremony
沒有兩種方法	no two ways about it
沒有其他	no other
沒有別的	none other than
沒有原因的反叛者	a rebel without a cause
沒有告訴	there is no telling
沒有問題	no question of
沒有囚犯	take no prisoners
沒有固定住所	of no fixed abode
沒有圍牆	fenceless
沒有多少剁	not much chop
沒有多少警察	not much cop
沒有對象	no object
沒有屋頂	roofless
沒有必要	noblesse oblige
沒有惡意	no offence
沒有想到	think nothing of
沒有意外	without accident
沒有意見	no comment
沒有成功的成功	nothing succeeds like success
沒有打完整甲板	not playing with a full deck
沒有數量	no amount of
沒有時間	have no time for
沒有更糟	none the worse for
沒有機會	no chance
沒有比賽	no contest
沒有消息就是好消息	no news is good news
沒有狗屎	no shit
沒有生意	have no business
沒有用	have no use for
沒有界限	know no bounds
沒有目的	to no purpose
沒有知道	there is no knowing
沒有禁止	no holds barred
沒有結束	no end
沒有結束	no end of
沒有結束	without end
沒有絲毫的	not in the slightest
沒有肥皂	no soap
沒有角的	hornless
沒有說話	there is no saying
沒有證明	not proven
沒有這樣的運氣	no such luck
沒有進一步	not go any further
沒有錯誤	and no mistake
沒有骨頭	make no bones about
沒有骰子	no dice
沒汗	no sweat
沒錢	moneyless
沒門	no way
沒關係	never mind
沖帳	strike a balance
沖床	puncher
河上	up the river
河牌	rivered
油和水	oil and water
油輪	oil the wheels
沾到	get on to
沾污	dish the dirt
沿著排水溝走下去	go down the drain
法律和秩序	law and order
法律規則	rule of law
泛出	pan out
泡沫在嘴裡	foam at the mouth
波折	twists and turns
波浪狀的	wave-like
注意	of note
注意力	attentional
泵鐵	pump iron
洗出來出來	come out in the wash
洗完	wash over
洗澡	take a bath
洗牌	shuffle the cards
洗牌	shuffler
洗禮	baptismal
洗臉刷牙	wash up
洩密者	leaker
活到最後	live up to
活在當下	live for the moment
活著再打一天	live to fight another day
活著和踢	alive and kicking
活著講故事	live to tell the tale
派上用場	come in handy
流失	run off
流淚	in tears
流淚	teary
流淚了	end in tears
浪費的	wasteless
浪費空間	waste of space
海上	by sea
海岸很清楚	the coast is clear
海拉爾	hailer
消耗戰爭	war of attrition
消防車	pumper
涼意	coolness
涼絲絲的	coolish
淮北市葉菜	leafed
深</s>。	rapture of the deep
深入	in depth
深端	the deep end
深處	deepness
混亂	mess with
混亂的水域	troubled waters
混和	mixable
清晰	clearness
清桌子	clear the table
清楚	in clear
清潔	cleanness
清潔某人的時鐘	clean someone's clock
清理	clean up
清理自己的行為	clean up one's act
清空氣	clear the air
清脆	crisply
清醒	soberly
清醒	wide awake
清除一些東西	clear something up
清除方式	clear the way
減少損失	cut one's losses
減速器	reducer
測試水	test the water
測量	measurer
測量容量	measure of capacity
游泳者	swimmer
游離度	freeness
渺小	smallness
準備地面	prepare the ground
準備好了	at the ready
準時	on time
準點	on the dot
溜冰者	skater
溢出	spill over
溢出自己的膽量	spill one's guts
溫暖	warmness
溫柔	tenderly
溫馨	homelike
滑入某物	slip something in
滑出	slip out
滑坡	slippery slope
滑落	slip up
滑走	slip away
滴一針	drop a stitch
滾動	roll on
滾石不生苔	a rolling stone gathers no moss
滿屋	houseful
滿杯	cupful
滿盤	plateful
滿袋	pocketful
漏	spillage
漏洞	hole out
演替	successional
漫長的時間	a month of Sundays
漸減	decreasingly
潛伏	lie low
潛入	dive in
潛水	take a dive
潮起潮落	ebb and flow
澄清電話	clarion call
激烈	fiercely
激烈反對	up in arms
激烈的事	something fierce
濁音	voiced
濕	wetness
濕在耳朵後面	wet behind the ears
濕淋淋	wetly
瀟灑	nuttiness
火冒三丈	hit the roof
火和硫磺	fire and brimstone
火在哪裡	where's the fire?
火焰噴射器	flamer
火的洗禮	baptism of fire
火線	line of fire
火花熄滅	spark out
火花飛翔	sparks fly
灰塵和灰燼	dust and ashes
灰色的	ashy
炫耀	show off
為...而死	to die for
為auld lang syne	for auld lang syne
為了	for aye
為了	in order
為了	make for
為了	up for
為了...的利益	for the benefit of
為了上帝的愛	for the love of God
為了保持	for keeps
為了做某事	in order to do something
為了善良的緣故	for goodness' sake
為了地獄	for the hell of it
為了它	be for it
為了安全起見	to be on the safe side
為了我的生活	for the life of me
為了效果	for effect
為了服用	for the taking
為了爭論	for the sake of argument
為了現在	for the present
為了確定	to be sure
為了紀念	in honour of
為了舊時的緣故	for old times' sake
為了表演	for show
為了詢問	for the asking
為了騎	for the ride
為什麼	for why
為什麼值得	for what it is worth
為你的想法一分錢	a penny for your thoughts
為公平	for fair
為我的錢	for my money
為所有季節	for all seasons
為月亮哭泣	cry for the moon
為自己想	think for oneself
為自己說話	speak for yourself
為鍋	for the pot
為非洲	for Africa
烤麵包	be toast
烹調的含	cookable
無主	masterless
無人	no man
無人知曉	placeless
無人駕駛	driverless
無光	lightless
無內胎	tubeless
無凹	pocketless
無味的	flavourless
無唇	lipless
無子女	childless
無尾	tailless
無序	out of order
無影	shadowless
無情節	plotless
無房	houseless
無所事事	apropos of nothing
無所事事	nothing doing
無指	fingerless
無星	starless
無框	frameless
無樹木	treeless
無水	waterless
無波	waveless
無焰	flameless
無環	ringless
無皂	soapless
無目的	objectless
無票	ticketless
無窗	windowless
無糖	sugarless
無罪	not guilty
無翅	wingless
無耳	earless
無聊之徒	trifler
無脂肪	fatless
無脈	pulseless
無臂	armless
無臭	scentless
無蓋	lidless
無袖	sleeveless
無論哪種方式	either way
無論如何	whatever next
無論是否	whether or no
無質量	massless
無足	footless
無趾	toeless
無路	pathless
無路可退	out on a limb
無邊	edgeless
無鎖	lockless
無鑰匙	keyless
無限制	without limit
無須	beardless
無頜	jawless
無頭	headless
無頸部	neckless
無風的	windless
無鱗	scaleless
焦油和羽毛	tar and feather
然後一些	and then some
然後在那裡	then and there
煙像煙囪	smoke like a chimney
煙霧和鏡子	smoke and mirrors
煤炭到紐卡斯爾	coals to Newcastle
煤質	coaly
照常營業	business as usual
照我看來	as I see it
照耀著	shine through
照耀著	take a shine to
照顧	look after
照顧	take care of
煩躁	fussiness
煮到	boil down to
煮書	cook the books
煮沸了	boil over
煮熟	doneness
熄滅了	brassed off
熄火	flame out
熄燈	lights out
熊掉了	bear away
熔爐	melter
熬夜	stay up
熱去小跑	hot to trot
熱又重	hot and heavy
熱和打擾	hot and bothered
熱烈	warmly
熱身	warm down
燃燒兩端的蠟燭	burn the candle at both ends
燃燒午夜油	burn the midnight oil
燒完	burn out
燒掉	burn up
燕麥	oaten
營銷	marketer
燥	rainless
燭台	candler
爆炸	blow up
爆炸了	bang on
爆發	break out
爬上小溪	be up the creek
爬下	climb down
爬到	creep to
爬得上去的	climbable
爭取時間	buy time
爭奪陣線	line of scrimmage
爭論之骨	bone of contention
爭論的	contestable
爭論道	argue the toss
父親	fatherhood
牆壁有耳朵	walls have ears
牆根	hided
牛奶和蜂蜜	milk and honey
牢牢	firmly
物有所值	value for money
物理	physically
特寫	close up
狂歡一場	live it up
狂跑	run wild
狗一樣	doglike
狗一樣的	doggish
狗吃狗	dog eat dog
狗和小馬錶演	dog-and-pony show
狗和骨頭	dog and bone
狗的抱怨	the dog's bollocks
狗的毛	hair of the dog
狗的生命	a dog's life
狡猾	slyness
狡猾的話	weasel words
猜測者	guesser
猶豫的人已經失去了	he who hesitates is lost
獅子的巢穴	the lion's den
獅子般的	lion-like
獨眼	eyed
獨立	stand alone
獰笑	grimly
獲得時間	gain time
獲得的味道	an acquired taste
獲得身體	get physical
玉米棒	corn on the cob
王八蛋	son of a bitch
王權	kingship
玩一些東西	play something out
玩地獄	play hell
玩場	play the field
玩市場	play the market
玩弄破壞	play havoc with
玩弄髒	play dirty
玩得很難	play hard to get
玩房子	play house
玩政治	play politics
玩時間	play for time
玩板球者	cricketer
玩火	play with fire
玩的狀態	state of play
玩神	play God
玩笨蛋	play dumb
玩第二個小提琴	play second fiddle
玩耍	play away
玩耍	play on
玩起來	play up
玩起來	play up to
玩遊戲	play games
玩遊戲	play the game
玫瑰樣	rose-like
玻璃般	glass-like
珍異	scarceness
現在	at present
現在	just now
現在你在說話	now you're talking
現在現在	now now
現在的武器	present arms
現成的	off the shelf
現行	in force
現金	cash in
現金在手	cash in hand
球在你的法庭上	the ball is in your court
球狀	spheral
理論上	in theory
瑪麗薩	findable
環狀的	ringed
瓶出來	bottle out
瓶和玻璃	bottle and glass
瓶蓋	capful
甜美的十六歲	sweet sixteen
甜美輕盈	sweetness and light
甜蜜	sweetly
甜蜜的nothings	sweet nothings
甜蜜的夢	sweet dreams
生	give birth
生動活潑	liveliness
生命之吻	kiss of life
生命之水	the water of life
生命和肢體	life and limb
生命的呼吸	the breath of life
生效	come into effect
生效	take effect
生根	take root
生氣	crossly
生氣	piss off
生活	live with
生活危險	live dangerously
生活和生活	live and let live
生活在地上	live off the land
生活在希望之中	live in hope
生活在快車道	life in the fast lane
生活在罪中	live in sin
生活方式	way of life
生活狀態	state of life
生活的事實	the facts of life
生活的工作人員	the staff of life
生活的麵包	the bread of life
生產資料	means of production
生病	get sick
生病了	be sick
生病到胃裡	sick to one's stomach
生病死亡	sick to death of
生病而累	sick and tired of
用什麼	what with
用分叉舌	with forked tongue
用地板擦拭	wipe the floor with
用它	with it
用完	run out
用完了	run out on
用完了氣	run out of gas
用完了蒸汽	run out of steam
用手	by hand
用水	by water
用火打火	fight fire with fire
用粗糙的光滑	take the rough with the smooth
用鼻子	by a nose
甩掉包袱	good riddance
由你自己	by yourself
由力	by dint of
由協會負責	guilt by association
由卡車	by the truckload
由和by	by and by
由我們自己	by ourselves
由於	by reason of
由於	due to
由於	on account of
由於	owing to
由書	by the book
由某人自己	by oneself
由頭	by the head
男人和男孩	man and boy
男人對男人	man to man
男人關於城鎮	man about town
男孩會是男孩	boys will be boys
留下來	leave it at that
留下來	stay put
留在	stay with
留意	keep an eye on
畢竟	after all
畫一個空白	draw a blank
畫一幅畫	paint a picture of
畫一條珠子	draw a bead on
畫一條線	draw a line under
畫出一些東西	figure something out
畫出短的稻草	draw the short straw
畫在	draw on
畫線	draw the line
畫蛇添足	gild the lily
異口同聲	with one voice
異性	the opposite sex
當一切已經說過並且做完了	when all is said and done
當和時	as and when
當場	on the spot
當它發生的時候	as it happens
當家	headed
當我住和呼吸	as I live and breathe
當然	for sure
當然	of course
當然	off course
當然	on course
當然了	a matter of course
當狗狗撞上風扇時	when the shit hits the fan
當芯片關閉時	when the chips are down
當道	hold sway
疏於練習	out of practice
疑	doubting
疣和所有	warts and all
疣狀	warty
疼痛	soreness
痛	bitterly
瘋狂	wildly
瘋狂的	cracky
癢癢	crawly
癢癢的象牙	tickle the ivories
登出	sign off
登錄	sign on
登陸	land up
發件人	addresser
發出聲音	make a noise
發問者	asker
發問者	questioner
發射	blast off
發抖	trembling
發揮作用	play a part
發揮出來	played out
發狂	craziness
發狂地	crazily
發現故障	find fault
發生	take place
發生事故等待發生	an accident waiting to happen
發瘋	go mad
發癢	itchiness
發白	whitely
發白的	whitish
發短信	send word
發紅	redness
發行	issuance
發行者	issuer
發言	take the floor
發誓	swear by
發誓	swear off
發誓	swear to
發送一個消息	send a message
發送給	send for
白了出來	white out
白人的負擔	white man's burden
白度	whiteness
白色的男人	men in white coats
百倍	hundredfold
百萬分之一	millionth
的snugness	snugness
的Twitter	twitterer
的一切事情	of all things
的一級	of the first magnitude
的全部	in its entirety
的力量	the strength of
的原因	in the cause of
的同類	of its kind
的大小	of a size
的定義	definitional
的年齡	of an age
的形狀	in the shape of
的必要性	of necessity
的情況下	in case of
的所有	of all
的方式	in the way of
的時刻	of the moment
的本質	of the essence
的標記	of mark
的目標	in goal
的目的	to the purpose
的第一水	of the first water
的粉紅色	pinkness
的老	of old
的調子	to the tune of
的選擇	of choice
的選擇	of one's choice
的長度和廣度	the length and breadth of
的順序	of the order of
皮樣	skin-like
盒子外面	out of the box
盒狀	box-like
盔	hatted
盛宴或飢荒	feast or famine
盡可能多	as many
盡可能多	as much
監護	wardship
盤狀	pan-like
目前	for now
盯著尾巴	sting in the tail
盲目的	eyeless
直	straightly
直	straightness
直上	straight up
直到母牛回家	till the cows come home
直到電線	down to the wire
直到鼻煙	up to snuff
直接蝙蝠	right off the bat
直而窄	the straight and narrow
直至另行通告	until further notice
相似性	likeliness
相信	believe in
相信	in the belief that
相反	as opposed to
相反	oppositely
相當一些	quite some
相當一點	quite a little
相當的東西	quite something
相處	get along
看一下東西	look something up
看一個人	look someone up
看一個人關於一隻狗	see a man about a dog
看不見	lose sight of
看不見	out of sight
看不見，不在乎	out of sight, out of mind
看不起	look down on
看世界	see the world
看世界去	watch the world go by
看到一些東西	see something of
看到一些東西	see something out
看到一些東西	see something through
看到一天的光	see the light of day
看到光	see the light
看到後面	see the back of
看到更好的日子	have seen better days
看到有人通過	see someone through
看到雙倍	be seeing double
看另一種方式	look the other way
看在上帝的份上！	for God's sake!
看後	see after
看得見	a sight to behold
看日光	see daylight
看星星	see stars
看時間	watch the time
看東西	be seeing things
看生活	see life
看看	see over
看看這部分	look the part
看穿	see through
看著光明的一面	look on the bright side
看見	catch sight of
看起來很嚇人	look a fright
看起來很好	look kindly on
看起來很小	look small
看起來很活潑	look lively
看起來很鋒利	look sharp
看起來有人上下	look someone up and down
看起來聰明	look smart
看這個空間	watch this space
看這裡！	see here!
看鐘	watch the clock
真實性	realness
真實性	trueness
真正的事情	the real thing
真正的文章	the genuine article
真理的時刻	moment of truth
真的	for real
真的很好	well and truly
真的真的	really and truly
真錢	real money
眨眼間	on the blink
眼巴巴	eagerly
眼淚	vale of tears
眼睛疼痛的眼睛	a sight for sore eyes
眼見為實	seeing is believing
眾多的罪惡	a multitude of sins
睜開眼睛	lay eyes on
睡個好覺	sleep tight
睡在它上面	sleep on it
睡在裡面	sleep in
睡著了	drop asleep
睡覺	sleep around
睡覺了	hit the sack
睡覺了	sleep over
睡覺很簡單	sleep easy
瞄準	take aim
瞧，	lo and behold
知情同意書	informed consent
知道了	be in the know
知道得分	know the score
知道是什麼	know what's what
知道最好	know best
知道比	know better than
知道誰是誰	know who's who
短小	shortness
短小的	smallish
短暫，震驚	short, sharp shock
短缺	short for
短而甜蜜	short and sweet
石頭之心	heart of stone
砂粒狀	sand-like
砍掉垃圾	cut the crap
研磨	grind on
砰的一聲	bang on about
破壞一條直腸	bust a gut
破敗某人的剁碎	bust someone's chops
破滅的厄運	crack of doom
破爛	raggedly
破船	break ship
破解	crack on
破解一本書	crack a book
硬奶酪	hard cheese
硬幣的另一面	the other side of the coin
硬指甲	hard as nails
硬的	hard by
硬而快	hard and fast
硬著頭皮	bite the bullet
硬起來	hard up
碧空	cloudless
碰撞和燒傷	crash and burn
確保	make sure
確定	be sure
確定	make certain
確定死亡	as sure as death
磚和砂漿	bricks and mortar
磨邊機	edger
礦主	mine host
祖母	grandmotherly
祝一個人好	wish someone well
祝一切順利	all the best
祝你今天愉快	have a nice day
祝你好運	for luck
祝福你！	bless you!
神格	godhood
神的人	man of God
神經之戰	war of nerves
神職人員的好處	benefit of clergy
禁果	forbidden fruit
禁止	barred
禿頭	baldness
私下	in private
秤	weigher
移動天地	move heaven and earth
移山	move mountains
稀薄的空氣	thin air
稍大	largish
稍短	shortish
稍長	longish
稍高	tallish
稱職	assed
稱重	weigh on
稱重	weigh out
稱重在	weigh in at
稱量體重	weigh in
稱雄	rule the roost
穩健	steadiness
穩坐	sit tight
穩步	steadily
空出來，騰出來	to spare
空氣和恩典	airs and graces
空白	blankness
空腹	on an empty stomach
空虛	hollowness
空虛地	emptily
空間不足	out of place
穿上	wear on
穿上狗	put on the dog
穿著殺了	dressed to kill
穿著襪子	stockinged
穿薄	wear thin
穿過T	cross the T
穿過地板	cross the floor
穿過屋頂	go through the roof
穿過網	slip through the net
穿鞋	shoeless
穿點東西	dress something up
突然	on a sudden
突然間	all of a sudden
突破	break out in
突破	break through
突破	break with
突破	topped
窩在家裡	hole up
竄氣吹	blow-by-blow
竊取	stealer
竊取節目	steal the show
立刻	at once
站出來	stand out
站在	stand in
站在	stand to
站在一邊	stand aside
站在儀式上	stand on ceremony
站在後面	stay behind
站在我身上	stand on me
站立在	stand over
站立拍拍	stand pat
站起來	stand down
站起來	stand someone up
站起來	stand up
站起來	stand up for
站起來去	stand up to
站起來算數	stand up and be counted
章節	chapter and verse
端到端	end to end
符合	in accord with
符合條件	come to terms with
符文	runic
第一	first up
第一件事	first thing
第一件事先	first things first
第一個表弟曾經被刪除	first cousin once removed
第一和最後	first and last
第一滴血	first blood
第一百	hundredth
第一眼	at first sight
第三個表弟	third cousin
第二個想法	a second thought
第二個表弟	second cousin
第二好	come off second best
第五	fifthly
第十一小時	the eleventh hour
第十九	nineteenth
第四十	fortieth
第四牆	the fourth wall
第四遺產	the fourth estate
筆墨	pen and ink
筆直走	go straight
等一下	hold on
等候接聽	on hold
等等	and so forth
等等	and such
等等	and the like
等等	wait for it
等等	wait up
等著瞧	wait and see
筒狀	tube-like
箍	hooped
算羊	count sheep
管下來	pipe down
管他呢	or whatever
管狀的	pipy
管道上	pipe up
箭頭	arrowed
節拍時間	beat time
簡單來說	in brief
簡短	briefer
簡簡	plain Jane
簡而言之	for short
簡而言之	in a nutshell
簡而言之	in short
簽名者	signer
簽收	sign for
簽收	sign off on
籬笆邊	side of the fence
籬笆那邊	over the fence
粉紅色	pinkish
粉鼻子	powder one's nose
粗暴的正義	rough justice
粗糙度	roughness
粗糙的人上來	rough someone up
粗糙的東西	rough stuff
粗糙的邊緣	rough edges
粗糙而準備	rough and ready
粗野	grossness
粘土的腳	feet of clay
粘性	stickiness
粘手指	sticky fingers
精巧	masterhood
精巧	mastership
精心	choicely
精打細算的日子	day of reckoning
精神世界	the spirit world
精神高於物質	mind over matter
精美	beautifully
糊塗	silliness
糖丸	sugar the pill
系列	in series
糾纏	foulness
紅	reddish
紅色在牙齒和爪子	red in tooth and claw
紅色的星球	the red planet
紙牌屋	house of cards
素食	meatless
索維	sower
索賠	stake a claim
紫色	purplish
紮實	solidly
累	tiredly
細	finely
組成	be made up
結合起來	in conjunction
結婚錢	marry money
結局的開始	the beginning of the end
結束	be over
結束	on end
結束一切	end it all
結束了	be the end
結束了	end on
結束了	over and done with
結束滿足	make ends meet
結果子	bear fruit
結果發現	turn out
結論是	in conclusion
結轉	carry over
絕不	in no way
絕望	desperateness
絞肉機	mincer
絢	decked
給一個男人	to a man
給一點想念	give something a miss
給了	give over
給予地方	give place to
給予聲音	give voice to
給些東西	give something in
給他媽的	give a fuck
給信	to the letter
給出一些東西	give something out
給別人一個手指	give someone the finger
給吮吸	give suck
給和採取	give and take
給嘴	give mouth
給我嗎 -	give me - 
給某人	give it to someone
給某人一個困難的時刻	give someone a hard time
給某人一天的時間	give someone the time of day
給某人一隻鳥	give someone the bird
給某人喊一聲	give someone a shout
給某人回來	pay someone back
給某人開機	give someone the boot
給自己的信用	to one's credit
給血	give blood
給謊言	give the lie to
給電池充電	recharge one's batteries
給魔鬼他應有的	give the devil his due
給點東西	give something away
給點東西	give something up
絹絲狀	silk-like
綁人	tie someone up
綁起來	tie something up
經受住時間的考驗	stand the test of time
經常沒有	as often as not
經過	go through
經過一段時尚	after a fashion
經驗法則	rule of thumb
綜上所述	in summary
綠地	greenly
綠色	greenness
綠色與羨慕	green with envy
網狀	in mesh
網狀	meshed
綻放是玫瑰花	the bloom is off the rose
緊張	tightness
緊急狀態	state of emergency
緊緊	tightly
緊貼	snugly
線狀	thread-like
線路輸出	line out
線阻力最小	the line of least resistance
緞帶	ribboned
編碼器	coder
緩慢	slowness
緩速器	retarder
練習的對象	the object of the exercise
縫合	in stitches
縮放	scaled
總共	in sum
總的來說	by and large
總的來說	on balance
總結	sum up
總而言之	all in all
總體上	on the whole
繁忙	busyness
繁榮景氣	boom boom
繞彎道	round the bend
繼續	carry on
繼續	go on
繼續	keep going
繼續	keep on
繼續	keep on at
繼續前進	move in on
缺乏	short of
缺乏思想	absence of mind
缺席讓心臟變得更加喜歡	absence makes the heart grow fonder
罐頭製造商	canner
罷工	strike in
羅馬不是一天建成的	Rome was not built in a day
羊肉	muttony
羊肉打扮成羊肉	mutton dressed as lamb
美元兌甜甜圈	dollars to doughnuts
美味	flavourful
美國主義	Americanism
美國夢	the American dream
美國性	Americanness
美在旁觀者的眼中	beauty is in the eye of the beholder
美好的一天	one fine day
美麗新世界	brave new world
美麗的人	the beautiful people
美麗的遊戲	the beautiful game
羽毛	featherless
羽毛之鳥聚集在一起	birds of a feather flock together
習慣的生物	creature of habit
翳影	fogginess
翻	turn over
翻車機	tilter
翻轉漢堡	flip burgers
翻轉腳本	flip the script
翻閱	flip through
翻閱	thumbed
翼狀	wing-like
老實說	to be honest
老氣	oldish
老火焰	old flame
老豆	old bean
老靴子	old boot
老鱒魚	old trout
考慮到	in consideration of
考慮到	take into consideration
而已	that's it
耙子	raker
耳	eared
耳環	dangler
耽誤	hold up
聖徒	sainthood
聚合	aggregation
聚在一起	stick together
聚會	get together
聞到一隻老鼠	smell a rat
聞到玫瑰	smell the roses
聞到血液	smell blood
聯合力量	join forces
聯手	join hands
聯繫	in touch
聯繫到	get hold of
聲明	declared
聲淚俱下	shed tears
聲稱	lay claim to
聲稱成名	claim to fame
聳立	towered
聽東西	be hearing things
聽理由	listen to reason
聽者	hearer
聾	deafness
聾啞	fall on deaf ears
肉和兩塊蔬菜	meat and two veg
肉和土豆	meat and potatoes
肉片	plates of meat
肉眼	the naked eye
肉體	physicality
肉體的罪惡	sins of the flesh
肌肉發達	muscled
肌肉起來	muscle up
肢	limbed
肥胖	fatness
肩	shouldered
肯定地	affirmatively
肯定的	in the affirmative
肯定的事	sure thing
背後有刺	a stab in the back
胸怀大志	aim high
能知	knower
脖子上的樹林	neck of the woods
脫掉	make off
脫掉	take off
脫掉	wear off
脫掉它	come off it
脫掉邊緣	take the edge off
脫穎而出	stand off
脫穎而出	to the fore
脫膠	come unglued
脫鉤	off the hook
脫離工作	out of a job
脫離步伐	off the pace
脫離聯​​合	out of joint
脫風	off the wind
腳先	feet first
腳的球	the ball of the foot
腳趾線	toe the line
腳趾腳趾	toe to toe
腴	thickish
腿	legged
膝蓋虛弱	weak at the knees
臉皮厚	have a thick skin
臉貼臉	cheek to cheek
臨陣退縮	cold feet
自動駕駛員	on automatic pilot
自娛自樂	please yourself
自己	be oneself
自己付錢	pay for itself
自己滾動	roll one's own
自己的	of one's own
自己的袖子	up one's sleeve
自己肯定	sure of oneself
自從	ever since
自然而然	come naturally
自由	at liberty
自由世界	the free world
自由和容易	free and easy
自由的土地	the land of the free
自豪的地方	pride of place
臭	stinky
至今	so far
至今還沒有	as yet
至少	at least
至於	as for
至於	as regards
至於	as to
至高無上	the Supreme Being
致使者	causer
致富快	get-rich-quick
致相關人士	to whom it may concern
與 - 	up with - 
與...一起跑	run with
與...共同點	in common with
與...同行	go along with
與...搭配	make off with
與...搭配	make with
與...相符	on a par with
與...開放	be open with
與上帝同在	with God
與之相反	contrary to
與兩個桶	with both barrels
與公司合作	in company with
與太陽	with the sun
與孩子	with child
與它一起出來	out with it
與年輕人	with young
與此同時	at the same time
與此有關	in connection with
與此相反的	to the contrary
與自己分開	divided against itself
興趣	interestingness
舉個例子	make an example of
舉手	raise one's hand
舉手！	hands up!
舉行堡壘	hold the fort
舉行法庭	hold court
舉證責任	burden of proof
舉起國旗	hoist the flag
舉起或閉嘴	put up or shut up
舊時代	the old days
舌頭	tongueless
航行	sailed
船桅	masted
良好的信譽	in good standing
艱難的方式	the hard way
艾芬	effing
芝麻開門	open sesame
芯片走了	chip away at
花一分錢	spend a penny
花了一個胳膊和一條腿	cost an arm and a leg
花式	fanciness
花點時間	take a fancy to
若隱若現	gleamingly
英國的花園	the garden of England
英寸	inch by inch
英雄所見略同	great minds think alike
茶和同情	tea and sympathy
茶杯裡的風暴	a storm in a teacup
莊嚴	royally
莊園的主人	lord of the manor
華納	warner
華麗地	splendidly
落入	fall in
落到位	fall into place
落在路邊	fall by the wayside
落後	behind time
落後	fall behind
落後於時代	behind the times
葉兒	leafless
葉狀	leaf-like
葉齡	leafage
著名十五分鐘	famous for fifteen minutes
著名遺言	famous last words
著手	set about
著火	catch fire
著火	on fire
著色器	shader
蓊	jungled
蓋上東西	cover something up
蓋帽	to cap it all
蓺	handiness
薄	thinly
薄	thinness
薩耶爾	sayer
藍色	blueness
藍色的男孩	boys in blue
藍色藍色	blue on blue
藏起來	hider
藤的果實	the fruit of the vine
蘋果和梨	apples and pears
蘋果和橘子	apples and oranges
蘋果永遠不會遠離樹木	the apple never falls far from the tree
處於劣勢	at a disadvantage
處於戒備	on guard
處於狀態	lie in state
處於自然狀態	in a state of nature
處於隔離狀態	in isolation
處理機	treater
虛幻	illusionary
虛心	humbly
號角	horn in
蜂鳥	hummer
蜜蜂的膝蓋	the bee's knees
螺旋	screw around
螺母和螺栓	nuts and bolts
蠕動	wiggly
蠟和減弱	wax and wane
蠟抒情	wax lyrical
血，汗和眼淚	blood, sweat, and tears
血和雷聲	blood and thunder
血比水厚	blood is thicker than water
血液和膽量	blood and guts
血王子	prince of the blood
血腥	bloodily
血腥	bloodiness
血腥細節	the gory details
行動勝於雄辯	actions speak louder than words
行動方針	course of action
行動的人	man of action
行動起來	act up
行尾	the end of the line
行蛆	act the maggot
行軍線	line of march
街道上鋪滿了黃金	the streets are paved with gold
衝擊波	blaster
衣領下熱	hot under the collar
表現原因	show cause
袋狀	sack-like
袖珍	pocketable
被拋棄	be cast away
被拋棄	be cast down
被放在	be put upon
被淘汰出局	lose out
被焚燒在樁上	be burned at the stake
被試者	testee
被說出來	be spoken for
被調入	be tuned in
被遺棄	be left for dead
裂了	crack up
裂縫多的	crannied
補丁	patcher
補償	make good
裝釘	tacker
裸奔	streaker
裸眼	glassless
裸露	bareness
裸露的牙齒	bare one's teeth
裸骨頭	the bare bones
複音	syllabled
褐色	brownness
褻慢	scorner
襪子和小牛皮	sock and buskin
要不然	or else
要么接受，要么離開它	take it or leave it
要做某事	be on to something
要做點什麼	be about to do something
要堅強	be hard on
要是	if only
要槍殺	be gunning for
要殘忍地要善良	be cruel to be kind
要求	call for
要責怪	be to blame
要長	be long
覆蓋	lay over
覆蓋海濱	cover the waterfront
見紅色	see red
規則的道路	rule of the road
規模	in scale
規模化	to scale
規模經濟	economy of scale
視情況可以是	as the case may be
視線	line of sight
視線	line of vision
視野開闊	on view
親吻	kiss up to
親吻並告訴	kiss and tell
親吻和彌補	kiss and make up
親愛的生活	for dear life
親自	in person
親近	closeness
解釋器	explainer
觸底	bottomed
觸摸	to the touch
觸摸	touch at
觸摸一個人	touch someone up
觸摸下來	touch down
觸摸基地	touch base
觸摸木頭	touch wood
觸摸自然	touch of nature
觸發	triggered
訂書機	stitcher
訂購	on order
訂購	to order
計劃A	plan A
計劃B	plan B
計算成本	count the cost
計費	billable
計費	billed
討價還價	bargainer
記住自己的事情	mind one's own business
記筆記	take notice
記錄在案	on record
設在家裡	set up home
設定一個人	set someone up
設定世界	set the world alight
設定步伐	set the pace
設定舞台	set the stage for
設定議程	set the agenda
設置	set to
設置一些東西	set something off
設置一些東西	set something out
設置具體	be set in concrete
設置在	set in
設置在運動	set in motion
設置場景	set the scene
設置東西	set something in
設置東西	set something up
許可打印錢	licence to print money
訴訟原因	cause of action
註冊	sign up
評論者	commenter
試用	on trial
試試	try it on
試試我	try me
試錯	trial and error
詫異	questioningly
詭秘	queerly
該做什麼和不該做什麼	dos and don'ts
該物種的女性	the female of the species
詳細	in detail
詳細介紹	go into detail
誇大妄想	delusions of grandeur
認出	make out
認為合適	think fit
認為是理所當然的	take for granted
認為是這樣	be of the opinion that
認為這個世界	think the world of
認真地	in earnest
認識聖經中的人	know someone in the biblical sense
誘人親吻	kissable
語重心長	earnestness
誤事	drop the ball
誤入歧途	go astray
誤差範圍	margin of error
說	that said
說“茄子	say cheese
說一條藍條紋	talk a blue streak
說來話長	it's a long story
說出來	speak up for
說同樣的語言	speak the same language
說夠了	enough said
說大話	talk big
說惡	speak evil of
說方言	speak in tongues
說話	speak one's mind
說話	speak up
說話	speak volumes
說話	talk to
說謊	lie off
說謊	lie over
說謊	lie with
說起	speaking of
說這個字	say the word
說髒話	talk dirty
誰去那裡	who goes there?
課程標準	par for the course
調出來	tune out
調成	tune into
調整	adjuster
調用曲調	call the tune
調皮	monkeyish
調速裝置	speeder
談火雞	talk turkey
談話	talk at
談話	talk down to
談話店	talk shop
談話感	talk sense into
談談	talk the talk
談論	talk about
請上帝	please God
請問	take issue with
請律師	take counsel
請求者	demander
請求者	requester
請注意	call attention to
請注意	pay attention
論證者	arguer
諾比	knobby
謊言	falseness
謙卑的居所	one's humble abode
講話	on speaking terms
謝幕	take a bow
謝謝	thanks to
謝謝一堆	thanks a bunch
證明	prover
證明有人錯了	prove someone wrong
警察	cop on
警察	cop to
警惕感覺	cop a feel
讀我的唇語	read my lips
變成	turn into
讓rip	let rip
讓一個人過來	make someone over
讓一邊下來	let the side down
讓事情滑落	let something slip
讓別人出去	let someone out
讓別人知道	let someone know
讓它一起出去	let it all hang out
讓我們來假裝	let's pretend
讓我告訴你	let me tell you
讓我看看	let me see
讓某人進來	let someone in
讓步	give in
讓步;讓路	give way
讓睡狗說謊	let sleeping dogs lie
讓秋天	let fall
讓自己出洋相	make an ass of oneself
讓路	make way
讓過去的人過去	let bygones be bygones
讓開車	let drive
讓飛	let fly
讚美是	praise be
讚美者	praiser
豆山	a hill of beans
豌豆狀	pea-like
豐厚	handsomely
象棋	scratcher
豪爽地	nobly
豬在中間	pig in the middle
豬樣	hog-like
豹子不能改變他的斑點	a leopard can't change his spots
貓和老鼠	cat and mouse
負責	in charge
負責	take charge
負載下	under load
貨到付款	cash on delivery
貪婪	tender mercies
貴重	preciousness
買它	buy it
買農場	buy the farm
貸款	on loan
貼片機	mounter
貿易地點	trade places
資助者	funder
資金	in funds
賣空	sell short
質樸無華	starkness
賭棍	gamester
贊成	in favour of
贏家	gainer
贏得一天	win the day
贏得積分	win on points
贏或輸	win or lose
赤膊上陣	shirtless
赤裸裸	nakedly
赤裸裸	stark naked
赤裸裸	starkly
走一下	make a go of
走下深處	go off the deep end
走了	be gone on
走了	come away
走了一百萬	gone a million
走出低谷，重新振作起來，重整旗鼓	out of whack
走出危險	out of danger
走出去	step out
走出去	step out on
走出去	walk out
走出路	step out of line
走出這個世界	out of this world
走出鐵軌	go off the rails
走吧	walk it
走在空中	walk on air
走在蛋殼上	walk on eggshells
走在街上	walk the streets
走強	going strong
走得太遠	go too far
走得很遠	go far
走板	walk the boards
走板條	walk the plank
走漏消息	spill the beans
走穩	go steady
走自己的路	go one's own way
走進	walk into
走進去	walk in on
走遍全身	walk all over
走過去	walk over
走開	get lost
走開	walk away
走開	walk away with
走開	walk off with
起作用	kick in
起來	heave to
起初臉紅	at first blush
起床	get up
起床	get up to
趁熱打鐵	strike while the iron is hot
超出測量	beyond measure
超出範圍	out of bounds
超時	out of time
超越以上	above and beyond
超越回憶	beyond recall
超越描述	beyond description
超越比較	beyond comparison
超越的背後	the back of beyond
超越蒼白	beyond the pale
超越面紗	beyond the veil
超過	over and above
超過某人的頭	over someone's head
越來越多	more and more
越來越少	less and less
越過高峰	over the top
趕上	catch up with
趕上人	catch someone up
趕上太陽	catch the sun
趕上燈光	catch the light
趕出來	snap out of
趕快	make haste
趕時髦的人	swinger
足夠好	well enough
足夠近了	near enough
趴在臉上	fall flat on one's face
趾	toed
跌幅	decliner
跑一英里	run a mile
跑來跑去	come running
跑來跑去	run along
跑出來	run off with
跑向	run to
跑在	run at
跑步	run its course
跑步跳	take a running jump
跑過，匆匆處理	run through
跑過來	run over
跑錯了	run an errand
距離任何地方	miles from anywhere
距離很遠	be miles away
跟上	keep up with
跟上來	catch up
跟上步調	keep pace with
跟上瓊斯	keep up with the Joneses
跟著下去	go down with
跟著去	go with
跟隨	follow on
跟隨	follow suit
跟隨	follow through
跨國	across country
跨欄運動員	hurdler
跨越	run across
路的盡頭	the end of the road
跳上	jump on
跳上下來	be jumping up and down
跳上潮流	jump on the bandwagon
跳下去	jump off
跳保釋	jump bail
跳出來	jump out
跳到結論	jump to conclusions
跳槍	jump the gun
跳舞的	danceable
跳船	jump ship
跳躍生氣	hopping mad
跳躍者	leaper
跳進去	jump at
跳進床上	jump into bed with
跳過	tick over
跳過籃球	jump through hoops
跳鯊魚	jump the shark
踏實	sureness
踏浪號	treader
踟	hesitating
踢下來	kick down
踢出來的狗屎	kick the shit out of
踢回來	kick back
踢某人，當他們失望	kick someone when they are down
踢某人出來	kick someone out
踢某人在牙齒	kick someone in the teeth
踢起來	kick up
踩水	tread water
蹄	hoofed
身體不舒服	under the weather
身體和靈魂	body and soul
身體美麗	the body beautiful
身高越高	tallness
躲避	avoidance
躲避	avoider
躺在	lay into
躺在後面	lie behind
躺在自己的牙齒上	lie through one's teeth
躺起來	lie up
車夫	puller
車輪和交易	wheel and deal
軌道的錯誤一面	the wrong side of the tracks
軟選項	soft option
輕	make light of
輕拍	flick through
輕拍背部	a pat on the back
輕推	nudger
輕而易舉	easy does it
輕觸	a light touch
輕輕一擊	strike a light
輕輕地在腳下	be light on one's feet
輕輕的	softly
輕鬆出路	take the easy way out
輝煌的隔離	splendid isolation
輪到	on the turn
輪到	to a turn
輪到了	out of turn
輪式	wheeled
輪流	by turns
輪轂和輻條	hub-and-spoke
輻條	spoked
轉一下	turn something in
轉一個人	turn someone on
轉個人	turn someone in
轉出來	spin out
轉動一下	turn something around
轉句	turn of phrase
轉另一個臉頰	turn the other cheek
轉尾	turn tail
轉桌子	turn the tables
轉移	make shift
轉過來	turn about
轉過潮	turn the tide
轉過身來	turn one's back on
轉過頭頭	turn of mind
轉頭	turn heads
辜負	let down
辣	hotness
辯手	debater
迎接	take up with
迫使問題	force the issue
迷	riddler
追上	catch on
追趕	play catch-up
追趕	run after
追追	give chase
追逐的快感	the thrill of the chase
追逐遊戲	chase the game
追龍	chase the dragon
退出	back out
退出	drop out
退後	back off
退後	stand back
退後	step back
退後，退下	back down
退避	escapable
送走	send away for
送餐上門	meals on wheels
逃學	play truant
逃跑	run away
逃跑	run away with
逃避者	escaper
逃離	get away
逆來順受	grin and bear it
透明度	openness
逐漸	by degrees
這些天	these days
這些禮物	these presents
這使得我們兩個	that makes two of us
這個例外證明了這個規則	the exception proves the rule
這個詞在街上	the word on the street
這只是時間的問題	it is only a matter of time
這場可怕	awfulness
這就是cookie崩潰的方式	that's the way the cookie crumbles
這就是生命	that's life
這就是生活	this is the life
這是一個很重要的想法	it's the thought that counts
這是一個想法	that's an idea
這是一個自由的國家	it's a free country
這是你的葬禮	it's your funeral
這是怎麼回事？	what's up?
這是想法	that's the idea
這是關於它的​​大小	that's about the size of it
這本書的人	People of the Book
這樣一個	such a one
這樣做	to that effect
這樣做	to the effect that
這邊	this side of
這里和那裡	here and there
這麼多	so much for
這麼多	this much
這麼近，但到目前為止	so near and yet so far
通力合作	pull together
通水	pass water
通過	by means of
通過	by way of
通過	fall through
通過	go through with
通過jingo！	by jingo!
通過一天的時間	pass the time of day
通過不擇手段	by hook or by crook
通過他們自己	by themselves
通過判斷	pass judgement
通過婚姻	by marriage
通過它自己	by itself
通過年齡	through the ages
通過心臟	by heart
通過擴展	by extension
通過權利	by rights
通過設計	by design
通過警棍	pass the baton
通過議案	go through the motions
通過選擇	by choice
通過電線	by wire
通過鼻子付錢	pay through the nose
速度	at speed
速度	quickness
速度與激情	fast and furious
造型	shape up
造型或出貨	shape up or ship out
造波	make waves
連天	groaning
連累	troubler
連續	in a row
連連看	mix and match
進來	be in for
進來	come in
進來	come in for
進來	get in with
進來	turn in
進入	come into
進入	enter into
進入	get in
進入	go into
進入世界	come into the world
進入行動	swing into action
進入軌道	into orbit
進入違約	step into the breach
進出	in and out of
進到那裡去	get in there
進去	go in for
進口港	port of entry
進攻	offensively
進行	get on
進行中	in progress
進行交談	make conversation
進行電話	telephonically
逼真	true to life
逼近	close in
遇到	run into
遇到了	come across
遇險的小姐	damsel in distress
遊戲已經結束了	the game is up
遊戲的名稱	the name of the game
遊戲結束	game over
遊戲開始	game on
遊行	on parade
運動	motional
運動員	thrower
運行	run on
運行	up and running
運行干擾	run interference
運行節目	run the show
運行色域	run the gamut
運行鎧甲	run the gauntlet
遍	all over
遍布店鋪	all over the shop
過來	come over
過來	come through
過去	go over
過去	pass go
過去	pass over
過去了	past it
過去的事情	a thing of the past
過夜	stay over
過好每一天	seize the day
過路人	passer
道歉	with apologies to
達克	ducker
達到劃傷	up to scratch
達到星星	reach for the stars
達到標準	up to par
達標	up to the mark
違反	go against
違約承諾	breach of promise
遙遠	far off
遙遠的	far and away
遠和寬	far and wide
遠處的動作	action at a distance
遠近	far and near
遠離	far from
遣散	lay off
適可而止	enough is enough
適可而止	in moderation
適合	fit in
適合和啟動	suited and booted
適合手套	fit like a glove
適合目的	fit for purpose
適合綁定	fit to be tied
適合胸圍	fit to bust
適合賬單	fit the bill
適者生存	survival of the fittest
遲早	sooner or later
遲緩	retardation
遲遲疑疑	hesitatingly
選擇一個人	pick someone up
選擇人	chosen people
選擇器	chooser
選擇器	picker
選擇少數	chosen few
遺漏的罪	sin of omission
避開	steer clear of
邁達斯的觸摸	the Midas touch
還可以的	fairish
還押	on remand
還是全部	still and all
還是小聲	still small voice
還沒有	nor yet
邊緣	on edge
那些日子中的一天	one of those days
那些是天	those were the days
那就是東西	that's the stuff
那是平的	that's flat
那會做的	that will do
那樣	that way
那裡，然後	there and then
那裡是	there it is
那隻鳥飛了	the bird has flown
邪惡	evilly
邪惡	evilness
邪惡的眼睛	the evil eye
部分	in part
部分公司	part company
部分家具	part of the furniture
都是微笑	be all smiles
酋邦	chiefdom
酋長太多，印度人不足	too many chiefs and not enough Indians
配對	pairwise
酒吧無	bar none
酷兒	queerness
酷玩	play it cool
酸溜溜	sourish
酸痛點	sore point
酸葡萄	sour grapes
醉了	blind drunk
醉酒無序	drunk and disorderly
醉酒駕車	one for the road
醒來，嗅到咖啡	wake up and smell the coffee
重來	start over
重力火車	gravy train
重寫歷史記錄	rewrite history
重心	centre of gravity
重擊-BAM-答謝你，夫人	wham-bam-thank-you-ma'am
重新發明輪子	reinvent the wheel
重新開始	start again
重火力	big gun
野性	wildness
野獸的本性	the nature of the beast
野生和羊毛	wild and woolly
量綱	bigness
釘	nailed
針	pricker
針和針	on pins and needles
針的眼睛	the eye of a needle
釣魚考察隊	fishing expedition
鈍地	dully
鉤，線和沈沒	hook, line, and sinker
鉤狀	hook-like
銀屏	the silver screen
銅環	the brass ring
鋪平了道路	pave the way for
錄製	recordable
錐子	piercer
錐子	stabber
錘子和鉗子	hammer and tongs
錯了	in the wrong
錯誤在一邊	err on the side of
錯誤的路	the wrong way round
錯過	let slip
錯過一擊	miss a beat
鍍金匠	plater
鍍金工人	gilder
鍵控	keyed
鍵控器	keyer
鎖，庫存和桶	lock, stock, and barrel
鎖喇叭	lock horns
鎖定	latch on
鎖定	lock on to
鎖定一個人	lock someone out
鎖定一個人	lock someone out of
鎖定到	latch on to
鏃	arrowy
鐘聲和口哨	bells and whistles
鐵樣	iron-like
鑽石在粗糙	diamond in the rough
長久	muchly
長出來	grow out
長命	long live
長在樹上	grow on trees
長在牙齒裡	long in the tooth
長大	grow up
長大了	grow on
長廊	galleried
長成	grow into
長期以來	over the long haul
長袖	sleeved
閃閃發光的	glittery
閃電條紋	streak of lightning
開	openable
開啟和關閉	on and off
開始	here goes
開始	kick off
開始	start in
開始	start on
開始	to begin with
開始	to start with
開始一個家庭	start a family
開始一點	start something
開始吧	get in on
開心地跳	jump for joy
開捕	catchable
開方	squarer
開槽	groover
開溜	bugger off
開火	go on fire
開火	open fire
開火了	fire away
開玩笑	jokingly
開玩笑	make fun of
開盤硬盤	drive a hard bargain
開航	make sail
開著玩笑	kiddingly
開裂	get cracking
開設店鋪	set up shop
間隔	at intervals
間隔	spacer
闖入	break into
關係不好	poor relation
關係到	relative to
關係詞的	relatival
關心	care of
關掉	cop off
關掉	turn off
關於	lay about
關於	up and about
關於什麼	what about
關於時間	about time
關於生與死的問題	a matter of life and death
關注中心	centre of attention
關閉一個人的工具包	get one's kit off
關閉但沒有雪茄	close but no cigar
關閉彈出	pop off
關閉書	close the books
關閉袖口	off the cuff
關閉記錄	off the record
關閉限制	off limits
防守	defensively
防禦	defensiveness
阻力最小的路徑	the path of least resistance
阿爾法和歐米茄	alpha and omega
附議者	seconder
除了	apart from
除了	aside from
除了	with the exception of
除了以外	all but
除了以外	anything but
除了名字之外	in all but name
除廚房水槽以外的一切	everything but the kitchen sink
除此之外	beside the point
陪審團出來了	the jury is out
陰晴圓缺	ups and downs
陰暗的	darksome
陰沉和厄運	gloom and doom
陷入困境	get hitched
陸續	in succession
陽光之光	ray of sunshine
陽光明媚的一面朝上	sunny side up
陽光直射	sunniness
隆重	grandly
階級行為	class act
隔壁	next door to
隨傳隨到	on call
隨意	at will
隨時隨地	as - go 
隨機	at random
隨機	randomly
隨機性	randomness
隨著	along with
隨著烏鴉飛逝	as the crow flies
隨身攜帶	go around with
隱藏深度	hidden depths
雄心勃勃	eager beaver
雇主	hirer
雌性	femaleness
雕刻機	engraver
雙手	pair of hands
雙程街	two-way street
雙翅片	gilled
離地圖	off the map
離很遠	nowhere near
離校	leave school
離線	out of line
離船	off the boat
離開	away with
離開	be away
離開	be off
離開	get away with
離開	get out of
離開	leave go
離開	leave off
離開	make away with
離開了腳	off one's feet
離開岩石	get one's rocks off
離開搖桿	off one's rocker
離開某人	leave someone be
離開機架	off the rack
離開牆	off the wall
離開者	leaver
離開這個生活	depart this life
離開門	leave the door open
離開電網	off the grid
雷迪	reddy
電力走廊	the corridors of power
電擊	shockable
電話	telephonic
需求	in demand
需要	in need of
需要一定	needs must
露出光芒	shed light on
露骨地	baldly
霸占	hogger
靈性	spirituality
靈性	spiritually
靈魂的窗戶	the windows of the soul
青春的泉源	the fountain of youth
靜水流深	still waters run deep
非常	grossly
非常	strongly
非常開心	over the moon
非線性	non-linearity
靠自己	on one's own
靠近	close by
靠近	close with
靠近心臟	close to one's heart
靠近骨頭	close to the bone
面對	faced
面對面	face off
面對面	to one's face
面對音樂	face the music
面無表情	blankly
面目全非	beyond recognition
靴子和所有	boots and all
靴子在地上	boots on the ground
靶向	targetable
鞋皮	shoe leather
鞠躬	bow out
鞦韆和迂迴	swings and roundabouts
鞭子	whips of
鞭手	the whip hand
鞭打	lash down
鞭打	whip in
鞭打某人的屁股	whip someone's ass
鞭打裂	crack of the whip
鞭狀	whip-like
鞭笞者	lasher
韌性	toughness
音樂的球體	music of the spheres
響亮地	out loud
響度	loudness
頂一下	to top it all
頂了	top out
頂嘴	talk back
頂級美元	top dollar
頂部	up top
頂部和尾部	top and tail
順便	in passing
順便一提	by the way
順其自然	go with the flow
順利	go well
順從	humbleness
順從	in obedience to
順我者昌逆我者亡	my way or the highway
順道	come by
預算	budgetary
頑皮	naughtily
頑皮	naughtiness
領	necked
領先	get ahead
領先	get the lead out
領先	lead off
領先	line ahead
領先一步	one step ahead
領先領域	lead the field
頭先	head first
頭和肩膀上面	head and shoulders above
頭暈	dizziness
頭暈目眩	the dizzy heights
頭會滾	heads will roll
頭骨和交叉骨	skull and crossbones
頭髮	haired
頭髮頭	head of hair
頰	cheeked
顆粒感	grainer
類似猿猴	apelike
類型	in type
顯示力量	show of force
顯示手	show of hands
顯示方式	show the way
顯示某人是老闆	show someone who's boss
顯著	conspicuously
風前	before the wind
風景的變化	change of scenery
風的變化	the wind of change
風雨同舟	through thick and thin
飛向面前	fly in the face of
飛在	fly at
飛得高	fly high
飛揚	flappy
飛旗	fly the flag
飛濺下來	splash down
飛濺出來	splash out
飛行	fly the coop
食宿	bed and board
食物思想	food for thought
飯菜：沒有調味汁	sauceless
飲水	waterer
首先	at first
首先	first of all
首先	in the first place
首先是最重要的	first and foremost
首先關閉	first off
首當其衝	bear the brunt of
馬上	right away
馬克爵士	Lord Muck
馬樣	horse-like
馬課程	horses for courses
騎牆	sit on the fence
騎起來	ride up
騎過去	ride roughshod over
騎霰彈槍	ride shotgun
騎高	ride high
驕傲	prideful
驚人	strikingly
驚喜，驚喜	surprise, surprise
驚嚇	take fright
骯髒	dirtiness
骰子死亡	dice with death
體育用品	sporter
體面	decently
高和低	high and low
高地	the high ground
高漲	run high
高而乾燥	high and dry
高而強大	high and mighty
高聲	loudly
高貴	nobleness
高跟	heeled
高跟鞋	head over heels
高跟鞋熱	hot on the heels of
高跳線	high jumper
鬆弛	looseness
鬆弛地	loosely
鬆懈	slackness
鬆鬆垮垮	slackly
鬍子	whiskered
魄力	boldness
魅力	loveliness
魔鬼的細節	the devil's in the detail
魔鬼要付錢	the devil to pay
魚形	fishlike
魚或切餌	fish or cut bait
鮑勃和編織	bob and weave
鮑勃為蘋果	bob for apples
鳥和蜜蜂	the birds and the bees
鳥樣	bird-like
鴨和潛水	duck and dive
鵝卵石	pebbled
麵包和水	bread and water
麵包和葡萄酒	bread and wine
麵包和馬戲團	bread and circuses
麵包師十幾個	baker's dozen
麻布和灰燼	sackcloth and ashes
麻煩和衝突	trouble and strife
黃銅猴	brass monkey
黃銅脖子	brass neck
黎明的裂縫	crack of dawn
黑	blackness
黑乎乎	darkish
黑了	black out
黑暗中總有一線光明	every cloud has a silver lining
黑色	blackish
黑色的黑	black-on-black
黑衣人	men in black
默認	by default
默默	silently
默默地	dumbly
點亮	be light on
點亮	light up
點亮	lit up
點亮保險絲	light the fuse
點對點	righter
點擊	on tap
點擊到位	click into place
點燃火	light a fire under
點頭的土地	the land of Nod
點點頭	on the nod
黽	strider
鼓起勇氣	nerved
鼻	nosed
鼻子到尾巴	nose to tail
齒形	toothed
