te	the
i	in
a	and
ki	to
e	yes
o	of
nga	the
ka	then
ia	him/her
mea	thing
ana	cave
ratou	them
ko	that
he	is
hoki	back
ahau	me
ano	again
ai	yes
Na	So
koutou	you
koe	you
kia	so that
Ihowa	Jehovah
me	with
atu	more
katoa	all
tangata	person
tona	his/her
mai	from
nei	now
hei	yes
mo	for
ra	day
A	A
tama	boy
tenei	this
na	so
tetahi	one
haere	go
Ko	It
Atua	God
kua	already
roto	inside
ta	print
to	deep
ake	more
whenua	country
toku	mine
tou	you
kore	no
kingi	king
runga	top
ma	white
iwi	tribe
whare	house
I	I
ona	its
E	Yes
tana	his/her
Iharaira	Israel
kei	here
hunga	people
tau	year
kahore	no
mahi	work
kupu	word
no	from
wahi	place
matou	us
iho	down
reira	there
nui	big
noa	normal
He	Yes
tonu	still
Ka	Yes
tatou	us
pa	city
rite	ready
ranei	or
korero	talk
pai	good
taua	war
ringa	hand
tekau	ten
noho	stay
taku	my
raua	both of them
ara	way
kihai	no
kino	bad
mate	death
wahine	woman
rua	two
rawa	property
puta	exit
aroaro	presence
kotahi	one
mau	hold
wai	water
tika	right
enei	these
kite	see
tera	that
ngakau	heart
ora	life
whakaaro	idea
hanga	build
ingoa	name
Kia	Okay.
tae	color
hoatu	give
Rawiri	David
Ariki	Lord
taha	side
kai	food
rangatira	leader
mohio	know
Ki	To
mano	thousand
aha	what
whai	follow
rongo	hear
tohunga	expert
kaua	don't
ou	you
Kua	Already
etahi	some
tapu	holy
muri	behind
hara	sin
Ihu	Jesus
pononga	servant
ke	foreign
wairua	soul
papa	father
kaha	strength
Hura	Hurrah
aroha	love
oku	mine
au	me
rangi	sky
tu	stand
mua	before
Mohi	Moses
meinga	cause
Hiruharama	Jerusalem
homai	give
matau	right
whakahere	offer
Me	I
Katahi	Then
toru	three
matua	parent
teina	younger brother
oti	finished
tikanga	method
engari	but
korerotia	tell
tena	that
pono	true
tahi	together
tukua	let go
hoa	friend
pera	like that
kanohi	face
mana	power
rau	leaf
wehi	fear
wa	time
reo	language
whitu	seven
marama	month
raro	bottom
Ihipa	Egypt
tamariki	children
titiro	look
kau	cow
poropiti	prophet
nana	see
kitea	found
patua	kill
whawhai	war
Kei	Yes
aku	mine
karanga	call
kakahu	clothes
kawea	bring
riri	anger
kainga	home
tino	very
riro	lost
wha	four
taonga	treasure
taea	possible
Heoi	However
utu	price
aua	no
whakapono	faith
mona	for him/her
Karaiti	Christ
ina	when
rima	five
tinana	body
ture	law
tamahine	daughter
waiho	leave
Nana	Look
takoto	lie down
whakahau	command
hua	fruit
waho	outside
ahi	fire
rere	run
maha	many
whanau	family
hipi	sheep
ata	morning
Kahore	No
whakarongo	listen
koura	gold
rakau	tree
waenganui	middle
ariki	lord
No	No
heoi	however
Kaua	No
tangi	cry
toto	blood
tangohia	remove
hoari	sword
waina	wine
ehara	not
kororia	glory
inoi	prayer
maunga	mountain
hoariri	enemy
aata	altar
kuwaha	gate
whakahoki	answer
kohatu	stone
Haora	Hour
mahara	memory
tango	remove
mata	face
waewae	foot
hapu	family
taro	bread
tohu	sign
kikokiko	flesh
patu	kill
teka	lie
whakawa	judgment
meatia	do it
moana	sea
whakatika	fix
ao	world
mangai	mouth
ianei	this
maku	for me
pouri	sad
mahia	do
koa	happy
Otiia	But
poke	dirty
whakarite	arrange
Hakopa	Jacob
tahuri	turn
mou	for you
po	night
meatanga	event
era	those
koraha	desert
atua	god
rapu	search
Arona	Aaron
whakaminenga	meeting
tupu	grow
ngaro	lost
tuakana	brother
toa	hero
whakaora	rescue
kararehe	animal
ahakoa	even though
anake	only
hari	happy
hiriwa	silver
mara	field
kawenata	covenant
pukapuka	book
Kingi	King
tatau	door
awa	river
tata	close
koia	that's it
Ano	Again
tapenakara	tent
tane	male
ono	six
moku	for me
anga	shell
taka	step
tahunga	burning
otiia	however
kingitanga	kingdom
whaea	mother
u	breast
huna	hide
Horomona	Solomon
roa	long
iti	small
Mo	For
Papurona	Babylon
whakahokia	return
whakaritea	arranged
tuku	release
konei	here
anahera	angel
patunga	victim
Riwaiti	Leviticus
turanga	foundation
Haere	Go
moe	sleep
matenga	death
Hurai	Jew
Pirihitini	Palestine
tokomaha	many
ope	army
Tena	Hello.
Parao	Pharaoh
haerenga	trip
maka	throw
inu	drink
akonga	student
hinga	fall
whakaatu	show
ahua	appearance
whakama	shame
Hei	Hey
kitenga	discovery
taiepa	wall
nohoanga	seat
tini	many
whatianga	elbow
huihui	gathering
Tama	Son
unga	send
tono	request
kawe	carry
taringa	ear
kaimahi	worker
whakapakoko	statue
Aperahama	Abraham
Hohepa	Joseph
tonoa	send
kaumatua	senior citizen
Matua	Father
rohe	border
Wairua	Spirit
mahue	left
ae	yes
pehea	how
hinu	oil
tahu	burn
witi	wheat
korua	you two
tuatahi	first
hoiho	horse
tuhituhia	written
aaka	ark
mutu	stop
hakari	festival
whakarihariha	disgusting
whakaorangia	save
tauiwi	foreigner
uri	seed
heke	down
Ma	White
oko	bag
maua	we
penei	like this
whakamatea	kill
Engari	But
puru	blue
hiahia	desire
Hohua	Joshua
ritenga	custom
kanga	curse
noatia	normal
huaina	called
Otira	But
tamaiti	child
tiketike	high
hea	where
tomo	enter
pou	post
whakarerea	abandoned
karangatia	invite
tuhituhi	write
moni	money
rawakore	poor
torona	throne
inaianei	now
tokorua	couple
rangatiratanga	kingdom
hou	new
naku	mine
ako	learn
oati	promise
whakatupuranga	generation
kiia	said
mamae	pain
huarahi	road
manaaki	welcome
teneti	tent
Horano	Jordan
kuao	young
whiwhi	get
waiata	song
pau	finished
putanga	output
ui	ask
pupuri	hold
hohoro	quickly
ena	that
matauranga	knowledge
rawhiti	east
kaitiaki	guardian
koropiko	worship
whakaako	teach
pu	gun
pito	end
hariata	carriage
whakamoemiti	praise
matamua	firstborn
poka	hole
waru	eight
whakatakotoria	set
nunui	big
whakakitea	reveal
puni	camp
hapati	Sabbath
Eparaima	Ephraim
Aue	Oh, oh
Moapa	Moab
hokona	sold
Pineamine	Benjamin
taenga	arrival
Kihai	No
upoko	head
tonga	south
tinihanga	deception
whakamarie	comfort
Ehara	Not
Tenei	This
kapua	cloud
Paora	Paul
whakarere	divorce
oneone	sand
ahei	yes
whaka	in
Hiona	Zion
mohiotia	known
Pita	Peter
rongonga	hearing
whakatata	approach
hau	wind
reme	lamb
kaihe	donkey
karakia	religion
temepara	temple
aianei	now
koati	goat
whakamate	kill
hamama	shout
marae	courtyard
parahi	copper
atawhai	kindness
whakahaua	ordered
ahiahi	evening
whakatakoto	set
tiaki	care
ua	rain
manu	bird
Tapu	Holy
mutunga	end
raki	north
Manahi	Manasseh
pena	like that
whiti	cross
kahui	flock
ataahua	beautiful
parae	field
Heremaia	Jeremiah
herehere	prisoner
raiona	lion
piki	climb
Ioapa	Joab
whakaturia	set up
tutu	violence
Hamuera	Samuel
whakaaturia	show
katahi	then
tahuna	burn
puku	stomach
ruma	room
whakamanamana	boast
Ahapa	Ahab
Maunga	Mountain
Koia	That's it.
Tera	That
peka	branch
hekere	shekel
wairangi	stupid
rama	lamp
whiu	punishment
aue	oh, oh
pukepuke	hill
mauria	carry
whakawhirinaki	trust
whiriwhiri	choose
marohirohi	brave
tutaki	meet
mura	fire
whakakakara	incense
Hoani	John
tawhiti	far
kakara	smell
tetere	trumpet
huihuia	together
Ihaka	Isaac
kopu	womb
tupapaku	dead body
Hetekia	Hezekiah
totokore	grain-free
whakaputaina	published
whakawhetai	thank you
hoko	buy
whakaoranga	salvation
Kireara	Gilead
ngutu	lips
rangimarie	peace
horoi	wash
nau	yours
whakaritenga	arrangement
Hamaria	Samaria
timatanga	beginning
peia	drive
pakaru	broken
reka	sweet
Ahiria	Assyria
ringihia	pour
raorao	valley
Honatana	Jonathan
kotiro	girl
puritia	hold
kaipuke	ship
moenga	bed
Mea	Things
whakangaromia	destroy
rawatia	completely
kamaka	rock
maroke	dry
poto	short
pumau	stable
puehu	dust
arero	tongue
kapu	cup
Ihipiana	Egyptian
kaiwhakaatu	witness
whakapai	improve
puaki	open
Ae	Yes
mahunga	head
tohe	insist
whanui	wide
Rawa	Very
kawana	governor
tumanako	hope
Ahakoa	Even though
tirohanga	view
whakanuia	celebrated
ahuareka	pleasant
hahi	church
rapua	search
rewera	devil
arahina	guide
maia	courage
tanumia	buried
tatari	wait
Whakarongo	Listen
utua	pay
whakahawea	contempt
here	tie
makona	satisfied
rongopai	gospel
kauwhau	preach
Apoharama	Absalom
minita	minister
rangona	heard
hapa	mistake
manene	immigrant
whiua	beat
piri	close
whakarau	exile
manaakitia	blessed
uru	enter
wareware	forget
iwa	nine
himene	hymn
O	Oh
maranga	wake up
waha	mouth
hipoki	cover
Ieropoama	Jeroboam
piko	bow
timata	start
kirehe	animal
Amona	Ammon
puna	spring
nohoia	inhabited
aru	follow
tupato	careful
tawhio	round
urupa	cemetery
miharo	surprise
hae	envy
whakangaro	destroy
hepara	shepherd
mawhiti	escape
rahi	size
kuware	stupid
rinena	linen
tokotoko	stick
Ehau	Esau
morehu	survivor
otira	especially
kake	good luck
rino	iron
whakanohoia	placed
eke	ride
hatepea	cut off
waenga	middle
whakatau	decision
whakaputa	publish
haona	horn
peratia	like that
oho	wake up
whakakake	proud
marena	wedding
Iraia	Elijah
whakaae	agree
taimaha	weight
tikina	get
whiriwhiria	choose
totoro	stretch
whakatupu	grow
Parihi	Parish
tahanga	naked
Kotahi	One
toenga	remainder
Kanaana	Canaan
kaki	neck
ngako	fat
whakawahi	anoint
ururua	waste
whitiki	belt
marie	calmly
whakaaturanga	exhibition
whakamiharo	amazing
karere	messenger
Eroma	Edom
Karari	Chaldean
manakohia	welcome
tiki	pick up
whakakahore	deny
take	reason
tutuki	complete
haereere	travel
whakaarahia	raise
hauauru	west
wawe	early
tuahine	sister
tirohia	check
horihori	vain
whakapehapeha	pride
oranga	life
turia	go
puremu	adultery
whakamutunga	last
hoia	soldier
whakapaingia	be blessed
wehea	separate
Amori	Amorite
kiri	skin
tahae	thief
Kaha	Strong
manako	hope
tepu	table
whakaara	wake up
Iehohapata	Jehoshaphat
tuarua	second
whati	break
pea	maybe
Paara	Bar
karaipi	scribe
wheua	bone
manawa	breath
whaia	follow
toe	again
ngatahi	together
haora	hour
haurangi	drunk
Hera	Sarah
awhina	help
paraoa	bread
nanakia	cruel
whakatekau	tenth
tukino	abuse
paru	dirty
Whakatika	Edit
maui	left
matapo	blind
wiri	shake
pouaru	widow
kaihanga	manufacturer
Raniera	Daniel
ririki	small
whakatapua	dedication
kotinga	cut
mania	plain
tuturu	permanent
whakatapu	consecrate
tokotoru	three
whakataka	cancel
Kariri	Galilee
motu	island
kopere	bow
whakapaipai	decoration
apotoro	apostle
rota	lot
pere	arrow
whakakeke	rebel
kapenga	Easter
parirau	wing
katoatia	all of them
okioki	rest
matekai	hunger
amo	bear
manga	branch
hawhe	half
ngoikore	weak
whakakahoretia	denied
arahi	guide
taitama	young man
pihi	sprout
wahia	split
Haimona	Simon
tohungia	be careful
murua	forgive
mawehe	leave
whakakite	show
whetu	star
tukinotia	abused
hita	cedar
Kara	Flag
Korero	Talk
whakahe	against
totohe	dispute
moepuku	sexual intercourse
Reupena	Reuben
Hiria	Syria
Hiriani	Syrian
Hopa	Job
kari	garden
hopukia	arrested
pirau	rotten
ringihanga	pouring
Rana	London
Amine	Amen
Riwai	Levi
arai	barrier
herea	tied
kawanatanga	government
mehemea	if
Peteere	Bethel
kaiwhakawa	judge
taitamariki	young
takotoranga	bed
Kanaani	Canaan
honore	honor
tuatoru	third
Ereatara	Eleazar
Heperona	Hebron
mataku	fear
wehenga	separation
ketia	change
maori	native
Meri	Mary
whanganga	measurement
pakeke	adult
oma	run
whakaakona	teach
whakatu	set up
nona	his/her
nohopuku	fast
hope	hope
Repanona	Lebanon
neke	move
papai	good
pourewa	tower
pani	smear
huruhuru	hair
aho	line
arohaina	beloved
purapura	seed
ika	fish
huihuinga	meeting
Ina	If
Hekeme	Shechem
whakaraua	exile
hira	important
parakore	pure
Ataria	Atalanta
tao	spear
whakangaromanga	destruction
tukunga	release
puranga	pile
okiokinga	rest
wehe	separate
hopu	catch
Apimereke	Abimelech
kaiwhakatangi	musician
riria	reprimand
taurangi	variable
kawa	bitter
ripeneta	repentance
whanaunga	relative
tutakina	shut down
kairau	prostitute
mahinga	work
parau	say
ngahere	forest
merekara	miracle
repera	leprosy
pei	drive
kupenga	net
horo	escape
uaua	difficult
Tukua	Send
keke	cake
kerupima	cherub
kara	color
pahua	loot
hinengaro	mind
whakaekea	attack
whakatikaia	corrected
taranata	talent
tapahia	cut
pahuatia	robbed
uma	chest
kapura	fire
Terekia	Zerekia
Heriko	Jericho
Paraama	Balaam
whatitoka	door
rerenga	flight
mehua	measure
whakanui	celebration
tarutaru	grass
ropu	group
whakatokia	planted
kamera	camel
kotia	circumcision
Apanere	Abner
Ihaia	Isaiah
whakapaua	spent
tapatahi	integrity
Aperama	Abram
Mororekai	Mordecai
weriweri	anger
Eriha	Elisha
turi	deaf
takoha	contribution
maro	hard
aranga	resurrection
whangai	feed
whakawakia	be judged
Pahana	Bashan
Aha	Yes
Ramahiku	Damascus
whakatangi	play
kauwhautia	preach
niho	tooth
meake	future
mekameka	chain
t	t
ioka	yoke
mauiui	pain
reinga	hell
whakanoho	place
Nui	Big
Ahera	Asher
Iehu	Jehu
maharatia	remember
panga	bank
tawai	insult
honi	honey
pahemo	past
horoia	clean
nohinohi	small
nakahi	snake
whakamatautau	test
pauna	pound
karauna	crown
haruru	noise
Taira	Tire
Ioaha	Joash
Noa	Noah
Paraka	Block
hemokai	hunger
tataramoa	thorns
ngohengohe	soft
hipokina	cover
whakaiti	reduce
whakapokea	defile
kapi	cover
kukupa	pigeon
Pirato	Pilate
rongoa	medicine
tiakina	protect
hemo	faint
kakaho	blonde
k	k
Nepukaneha	Nebuchadnezzar
rewenakore	unleavened
whakaaroa	think about
whakangungu	training
aonga	useful
Ehetere	Esther
mowhiti	ring
ngangau	noise
kiano	not yet
peihana	bowl
hui	meeting
pawera	fear
tapapa	flat
takahi	violate
Haroko	Haruko
Hamana	Haman
Rapana	Laban
Runga	Top
kohakore	flawless
haea	tear
ringaringa	hand
apopo	tomorrow
Hohia	Hosiah
tawahi	abroad
papaki	patch
karaipiture	scripture
manawanui	patience
uruta	epidemic
torutoru	few
epora	ephod
whakapumautia	confirmed
Napatari	Naphtali
Peterehema	Bethlehem
Miriana	Midian
matara	far away
hiako	leather
pakiaka	root
awhi	hug
whakakiia	fill
aki	push
hohonu	deep
whakato	plant
makawe	hair
tapae	offer
whakahaere	management
ngawari	easy
Hakaraia	Zechariah
whakaeke	attack
runanga	meeting
awatea	daytime
whatu	eye
whakapataritari	provoke
pungarehu	ash
whakamarama	explain
ware	poor
Rehopoama	Rehoboam
noku	mine
Hatana	Satan
Tangohia	Remove
korerotanga	conversation
whakapuakina	declare
whakamahara	reminder
Himiona	Simeon
ururuatia	deserted
raruraru	problem
whakawehi	scare
pane	head
koroheke	old
hiri	seal
kokoti	harvest
ahu	head
whakakororia	glorify
momona	fat
pehi	press
pokohiwi	shoulder
Horoma	Sodom
whakaherea	offer
pakanga	war
taratara	rough
hu	shoes
wera	hot
kohikohi	collect
rihi	dish
tua	back
whakahekea	exile
akina	push
whakapuaki	express
karepe	grapes
Hepurona	Zebulun
Hiti	Hit
Iehoiara	Jehoiada
kaiwhakaora	healer
Rahera	Rachel
wira	wheel
puawai	flower
whanautanga	birth
harakore	innocent
waiu	milk
horomia	swallow
Tauiwi	Foreigner
kaiwhakaako	teacher
awaawa	valley
inumia	drink
muru	erase
Ihimaera	Ishmael
wawahi	break
kohukohu	gossip
rarangi	list
moti	peace
kuri	dog
whakakitenga	exhibition
oriwa	olive
Homai	Give
kaieke	rider
oha	hello
kata	laugh
tanga	lazy
Ahia	Asia
Kipea	Gibeah
Hehe	Yes
Herora	Herod
whekau	intestines
Hiperu	Hebrew
rokohanga	discovery
otaota	herb
takiwa	district
Tikina	Get it
matapihi	window
whakawahia	judged
taupoki	lid
Huria	Judea
tanumanga	burial
epa	ephah
matakitaki	watch
oumu	oven
tihi	peak
haehae	tear
memeha	fade
whakatupato	warning
Himei	Shimei
Mau	You
whakau	confirm
Kaiwhakaako	Teacher
ngangana	red
taima	time
peke	jump
Kati	Stop
marara	umbrella
whakatupuria	raised
pukupuku	tumor
Mehemea	If
iriiria	baptized
Ahata	Ahaz
atarangi	shadow
whakamana	confirmation
tehea	which one
pehia	pressure
whakarewa	metal
waipuke	flood
kuini	queen
onamata	ancient times
kaititiro	witness
oatitia	swear
Titiro	Look
iriiri	baptism
Rite	Ready
kohikohia	collect
tonutia	continue
koroka	cloak
hapai	handle
Natana	Nathan
kete	basket
papura	purple
kopikopiko	wandering
hungawai	mother-in-law
mahanga	twin
ngarahu	ink
kotiti	stray
pokekore	clean
whakahi	ridicule
whanga	harbor
riringi	pour
hapainga	departure
mauahara	hatred
kaituhituhi	writer
Nau	You
tapaea	offer
takahia	trample
Ihakara	Issachar
Penaia	Benaiah
mohoao	wild
koki	angle
kawenga	responsibility
Mihipa	Mizpah
korerorero	chat
kihi	kiss
ripekatia	nailed
tokowhitu	seven
whakamahau	porch
Ara	Way
karangatanga	call
whakapae	accusation
tutei	spy
kaiwaiata	singer
Kiriona	Gideon
pangia	infected
pi	bee
whakaoho	wake up
potae	hat
Kirikara	Gilgal
rongoatia	treated
tupono	chance
kakahuria	dress
Kariki	Greece
Hara	Crime
Amatia	Start
Hemaia	Shemaiah
Merari	Merari
whakahua	mention
Iepuhi	Jebusite
Hamahona	Samson
Hinai	Sinai
ngokingoki	crawl
rire	deep
mangere	lazy
Ta	Print
Eri	Eli
aia	there
whakapaea	besiege
whakapati	flattery
Hemi	James
kinotia	bad
whakakorea	cancel
kaiwhakatakoto	planner
nuinga	most
oki	oak
Heira	Sheila
Whakamoemititia	Praise
Hai	Hello
kohia	collect
hurahia	reveal
whakaititia	be humbled
whakamararatia	scattered
poropititanga	prophecy
aitua	accident
mohoa	now
tukitukia	smashed
taupokina	covered
karapotia	surrounded
moemoea	dream
tupuna	ancestor
matewai	thirst
tamarikitanga	childhood
amuamu	complaint
tomokanga	entrance
Hehepona	Heshbon
Ietereere	Jezreel
Mika	Micah
Karepe	Grapes
Koraha	Desert
pohehe	mistake
Rota	Lot
whakaarokore	thoughtless
hono	connect
nikau	palm tree
Maku	For me
tawhito	old
mahaki	patient
whakamoemititia	praise
matenui	passion
Iehoiakimi	Jehoiakim
Ahatia	Ahaziah
matakite	vision
Naku	Mine
Te	The
Hamata	Hamath
Uria	Uriah
miro	thread
whakapoke	pollute
Piripi	Philip
mongamonga	pieces
ketanga	change
kaipahua	robber
whatitiri	thunder
Moana	Ocean
Rama	Lamp
pikitanga	climb
haunga	except
Ha	Yes
tungane	brother
motuhia	cut off
kati	close
Makiri	Macri
hunaonga	daughter-in-law
uha	female
purea	clean
whero	red
kohua	boil
unuhia	withdraw
pikaunga	burden
mawhitiwhiti	locust
ru	earthquake
tomairangi	dew
whakamutua	stop
tanu	bury
akiritia	thrown away
whakakororiatia	glorify
huri	change
tuwhera	open
wahie	fuel
whakamataku	scary
Kipeono	Gibeon
maunu	bait
tuara	back
nou	you
Rea	Leah
hapahapai	lift
uira	lightning
ekara	eagle
ngiha	fire
aritarita	anger
marere	fall
titi	stick
Waiho	Leave
koko	spoon
whakairo	carving
Hihona	Sihon
teitei	high
Hiro	Hiro
honoa	connect
ngatahitia	together
paingia	popular
whakaponokore	unbeliever
ripeka	cross
tohutohu	advice
hanganga	structure
Hirikia	Hirkia
Peerehepa	Beersheba
Kata	Laugh
nuitia	generally
hurihia	change
Hairona	Sidon
konatunatua	mixed
taanga	date
paowa	smoke
roimata	tears
keti	gate
whakapa	contact
tuanui	roof
huha	thigh
wahangu	silence
kaiponuhia	withheld
kaihoko	seller
whakakikoruatia	coated
takakau	single
apo	greedy
mataara	watch
kohungahunga	infant
whanoke	wrong
whakaheke	reduce
ngohi	line
whakahonore	honor
whakauru	join
parei	barley
Pera	So
Arama	Adam
numinumi	shy
koti	jacket
takahanga	event
Hona	Jonah
rui	sow
tangihanga	funeral
Hoki	Back
waihoki	anyway
whakahaweatia	despised
aro	attention
pata	butter
takanga	event
tapiri	add
Mana	Power
Kiriata	Film
tere	fast
kokotikore	uncircumcised
Hepa	Sheba
Ripeka	Rebecca
Nepukareha	Nebuchadnezzar
poipoi	ball
Ahahueruha	Ahasuerus
kopa	lame
tote	salt
poauau	stupid
pure	prayer
takai	wrap
whakakakahuria	dress up
whakamamae	torture
tapiritia	added
whakatauki	proverb
kaitohutohu	advisor
hutia	uproot
whakamatau	try
tapoko	enter
kahakina	kidnapped
Hapana	No
parakete	prey
Keraria	Gedaliah
tokorima	five
Kohata	Gold
Reme	Lamb
hokohoko	trade
ngangare	conflict
ohorere	surprise
whakaari	drama
whakautu	answer
Pahia	Persian
rore	trap
Iepeta	Jephthah
pamekaranete	pomegranate
Hiha	Caesar
whangaia	feed
Kawea	Carry
Panapa	Barnabas
manukanuka	worry
wiki	week
whakatoi	harassment
whakainumia	water
kakau	handle
whakahuatia	mentioned
hatere	harp
Apiatara	Abiathar
Moapi	Moab
h	h
werohia	injection
Nahareta	Nazareth
whakaaroaro	think
ngaru	wave
ngau	bite
taia	print
Iehorama	Jehoram
Tahuri	Turn
whakatikanga	correction
hokinga	return
ipu	container
Nunu	Nunu
kaihokohoko	merchant
r	r
rewena	yeast
kona	there
Waihoki	Likewise
tirotiro	browse
hihiko	enthusiasm
Hanania	Hananiah
kauaka	no
maihao	finger
raru	problem
tuawha	fourth
Erama	Elam
maru	bruise
nekehia	move
pakia	slap
tawainga	insult
tukinotanga	oppression
pakitara	wall
turoro	patient
whakakaha	strengthen
whitikiria	belt
Paaha	Pasha
whakapouri	sad
nonohi	young
whakakapi	substitute
kianga	phrase
tutukitanga	achievement
whakapapa	genealogy
kaiwhakahaere	manager
Harumu	Harum
Apia	Apia
Whakaorangia	Save
paku	small
Utia	Ask
Tarahihi	Tarshish
hitimi	acacia
waharoa	square
raumati	summer
ihu	nose
wawahia	broken
toronga	extension
Whero	Red
whakaahua	photo
kaitirotiro	inspector
ruia	sow
Oha	Hello
Makeronia	Macedonia
Muri	Next
Penei	Like this
whakamanawanui	be patient
Ramoto	Ramot
tuohu	bow
Hehua	Jesus
ngohe	soft
takina	check
taru	weed
ha	yes
whakawakanga	trial
whakahari	cheer up
paihere	bundle
piringa	shelter
tahuritanga	conversion
putia	closed
Peneharara	Ben-Hadad
puke	hill
whakahokinga	return
Aua	Thank you.
tinihangatia	deceive
whakamarietia	comfort
hiakai	hungry
pakari	strong
Etera	Ether
Amanono	Amnon
tauira	model
taumaihi	tower
tokowha	four
kaitono	candidate
Iotama	Jotham
Poaha	Boaz
Tamara	Tamara
Amareki	Amalek
ga	yes
Teruia	Teruia
Epere	April
Paruku	Baruku
kouma	chest
whatiia	break
keri	dig
kinongia	hate
paheke	slip
whakaroa	delay
mokemoke	lonely
whakaharahara	critical
unaka	eunuch
whakairia	posted
matamata	watch
rae	forehead
hine	girl
kokonga	corner
whakarewaina	launch
karapoti	surround
whakarunga	up
onepu	sand
m	m
Hoatu	Apply
Mikaia	Micaiah
keria	dig
Karamere	Caramel
Nepata	Nebat
akona	teach
whakatangihia	played
matauria	known
whakakakahu	dress
matenuitia	desirable
whakahonoretia	honored
tuwha	spit
roroa	tall
Mehurama	Meshullam
Herupapera	Zerubbabel
Aronia	Adonia
kanapa	bright
whakaminea	gather
wehingia	be afraid
kanikani	dance
whakapaia	improve
kukume	attract
hukarere	snow
Apihai	Abihai
Amareke	Amalek
tarakona	dragon
Tariuha	Darius
kaitukino	attacker
keneturio	centurion
Roma	Rome
atawhaitia	take care
koi	sharp
Hairuha	Cyrus
Iehoahata	Jehoahaz
Rakihi	Rakhi
koha	gift
pororaru	chaos
ngaromanga	disappearance
pakoko	barren
makutu	witch
matotoru	thick
taura	rope
parekura	disaster
akuanei	now
Ietepere	Jezebel
memenge	wither
tira	train
mahana	warm
Kaiwhakaora	Savior
wewete	loose
Timoti	Timothy
tangihia	cry
Pinehaha	Phinehas
tunua	cook
whiunga	punishment
hi	hello
minamina	envy
Iapehe	Jabesh
taikaha	violence
Hiwi	Hiwi
Hema	Hema
Huhana	Susanna
humarie	calmly
toro	visit
pene	pen
whakamoti	destroy
whakawhiti	transfer
poaka	pig
tupuhi	storm
Komora	Gomorrah
horapa	spread
ruru	shake
uia	ask
hianga	deceit
ngahoro	hurry
poropititia	prophesy
tauhiuhia	sprinkle
Perihi	Parish
tapahi	cut
kumea	pull
Hataere	Saturday
tahia	clean
whaki	confession
Nga	The
taunu	shame
whakatoia	persecuted
wero	challenge
Meinga	Cause
tautangata	foreigner
Iorama	Joram
para	garbage
Maaheia	Sorry.
Hirama	Hiram
Kerara	Gerar
Huru	Hair
pupirikana	publican
taunaha	pledge
wehewehea	divided
puhoi	slow
marietia	calmly
manawapa	sorry
uhunga	mourning
whakaputaia	published
tineia	extinguished
Napara	Nabara
uhi	cover
w	w
ngakaukore	heartless
tuhi	write
kurupae	beam
Oka	Oak
Napoto	Naboth
whakapumau	confirm
whakaotinga	completion
whakamotitia	destroy
whakawaha	load
maumau	useless
whakarerenga	divorce
pae	site
Rapa	Giant
takaro	play
Kihi	Kiss
kaimau	carrier
Naomi	Naomi
Rutu	Ruth
mangu	black
kahu	clothes
rerengia	fly
maturuturu	drop
whakanoatia	be defiled
Harai	Syria
taitamarikitanga	youth
rewa	melt
waro	coal
pania	painted
Ahiriana	Assyrian
whakapakeketia	hardened
Amoho	Amos
Etiopia	Ethiopia
kaiawhina	assistant
whakapakeke	harden
whakainu	watering
hikoinga	step
pehipehi	ambush
tahitia	together
Hihera	Sisera
Maka	Throw
kapea	copy
whakamatautauranga	test
hore	old man
whakaukia	confirm
uta	load
hata	hat
Akihi	Akihito
taria	wait
whakaahuareka	beautiful
marenatia	married
Petehemehe	Beth Shemesh
Amono	Ammon
wikitoria	victory
Itamara	Itamar
Harana	Haran
Uparati	Euphrates
kaiwhakarite	organizer
Erekana	Elkanah
Maaka	Food
tiupiri	jubilee
tumatakuru	blackberry
takatakahia	trample
whawhati	break
popoki	cat
kerekere	big
tiaho	bright
Arapa	Arabic
kinaki	seasoning
Ninewe	Nineveh
matomato	green
whakauaua	difficult
matatau	advanced
whakapouritia	darken
Ahikama	Ahikam
tuaina	harvest
Erene	Eden
whakanekehia	move
kaikohuru	murderer
whakamahia	used
paopao	pop
n	n
ruha	tired
kiko	flesh
Ekerono	Ekron
kahakore	helpless
Hatoro	Hazor
parori	pervert
kerupa	cherub
kauri	fir
whakaoati	swear
Aherimi	Asherim
rapea	maybe
awhinatia	help
Heraia	Seraiah
Ahitopere	Ahithophel
Netania	Netanya
paunatia	weigh
unu	pull
haereerea	travel
Natapa	Natap
Heterono	Hezron
Eromi	Edom
Hararetere	Hadareter
tuwhaina	spit
Opereeroma	Ophel-Edom
tatu	tattoo
Eriapa	Eliab
Oparia	Obadiah
Amoni	Ammon
Hoera	Joel
hopohopo	worry
Pai	Good
marangai	east
pupuhi	shoot
kairautanga	prostitution
papapa	straw
kokiri	rush
whakapaparanga	family tree
hoha	boring
ruarua	doubt
Anatioka	Antioch
Hira	Hira
ngenge	tired
miharotanga	surprise
aronga	direction
whakamatautauria	test
Aharoro	Ashdod
pokaia	surgery
whakamamaetia	tortured
utaina	load
Hanga	Build
mama	mother
matea	need
Kaina	Cain
manaakitanga	blessing
heu	razor
tononga	application
Arara	Arad
whakapangia	be blamed
timipera	drum
Tearimi	Tearim
muera	mule
pareparenga	bank
Eraha	Elah
Nahora	Nahor
Manoa	Manoa
whakakai	earrings
remu	skirt
Karehe	Kadesh
hiritia	sealed
ngaua	bite
hinganga	fall
haehaea	torn
kuhua	put
painga	advantage
tapa	edge
Topia	Topia
Tatou	Us
whitinga	crossing
ngautuara	gossip
Hukota	Succoth
rato	rat
kohuatia	boiled
poutumarotanga	noon
paepae	tray
Tirita	Tirzah
manuhiri	guest
inoia	please
tautohe	argument
Netinimi	Nethinim
Ripina	Ribbon
Rimono	Lemon
Keira	Keira
Omori	Omori
Kerehona	Gershon
koroheketia	old age
tarai	cut
whakaaria	promise
piro	score
tautau	cluster
Kari	Kari
Opere	Opera
Atahere	Atahere
Hini	Chinese
Hama	Ham
Pa	City
wetekina	untie
koromatua	mayor
kaho	bar
whatukuhu	kidney
Aranona	Arnon
tuaahu	fortune-telling
paroro	storm
hepeta	scepter
pokanga	surgery
whakahauora	refresh
Hiharia	Caesarea
toia	drag
tukauati	hurricane
kikino	bad
Iehoaha	Jehoahaz
wharau	hut
wahanga	section
whakakikorua	coating
turaki	overthrow
Etiopiana	Ethiopian
whakamarietanga	consolation
uakina	open
whakatupehupehu	reprimand
Tika	Right
pukutia	secretly
whakakahangia	strengthen
putea	bag
whakaputanga	publication
niao	bird
ahurewa	universe
Puta	Exit
Horepa	Horeb
urunga	entrance
kouru	gold
whakangaueuetia	shaken
maringi	spill
Kuini	Queen
whakapohehe	deceive
ahatia	what happened
tuari	wait
tunga	middle
whakamakuku	watering
hotoke	winter
Epeha	Ephesus
putorino	pipe
turakina	demolished
watea	available
parakihe	incense
Naamana	Naaman
Horo	Horo
araia	forbidden
Eriahipi	Eliashib
Iahata	Jahath
Hepere	Heber
Amaha	Morning
Apikaira	Abigail
Heraha	Serah
houhia	reconcile
Waiata	Music
Mikara	Michal
Hemana	Heman
Erihama	Elishama
himipora	cymbal
tuaono	sixth
Reupeni	Reuben
Roro	Brain
kaikawe	carrier
Whanau	Family
Tepa	Tepa
Kaperenauma	Capernaum
whakamuri	back
poipoia	nurture
maira	please
whanariki	sulfur
maharatanga	memory
ne	no
wuruhi	wolf
horahia	spread
Tipa	Tip
Rapahake	Rabahake
whakaaetia	allowed
whiri	braid
taiawhio	circuit
kaata	cart
tohea	argue
tirotirohia	check
ngote	suck
whakapakia	put on
whakautua	answer
homaitanga	donation
mamao	far away
wherahia	spread out
whaowhina	help
pati	bath
ruri	survey
haua	disabled
hoatutanga	donation
marangatanga	awakening
hia	how much
rapunga	search
Periara	Beliar
tauria	attack
Maranga	Wake up
titaria	scattered
rei	queen
tekateka	sly
erangi	yes
whakaneke	move
whakaohokia	wake up
whakaraunga	exile
whawhaitanga	battle
Iepune	Jephunneh
Nere	Ner
Matania	Mattaniah
Ahimereke	Ahimelech
Amaria	Amariah
toki	axe
ngaueue	shake
hautopea	cut off
Ierutunu	Jeduthun
Rapua	Search
Aminarapa	Aminadab
Utiere	Utility
Hakara	Hagar
Peoro	Peor
Anaha	Look.
Haraha	Salah
Kaiiriiri	Baptist
Whakapaingia	Blessed
kaiwhai	hunter
Raharuhi	Lazarus
paoa	smoke
patito	itch
whatumanawa	emotions
Miriani	Midian
Eperona	Ephron
Arataherehe	Artaxerxes
Kohena	Goshen
ate	liver
hora	spread
whakatuwhera	open
haerea	go
Apereneko	Aberdeen
Mehaka	Meshach
Hataraka	Shadrach
whakatahuritia	convert
kaituku	sender
atatu	early
pupu	baby
katipa	officer
murunga	forgiveness
kuhunga	entrance
whakairihia	hang
Mepipohete	Mephibosheth
Oriwa	Olive
pereki	brick
takaia	wrapped
kohi	collect
pakira	bald
Ionarapa	Jonah
puare	open
tihokahoka	booth
Eriakimi	Eliakim
waiatatia	sing
pikitia	picture
Peka	Branch
Patua	Kill
whakamau	to fasten
pouaka	box
tatauranga	statistics
hiku	tail
tarewa	loan
kowhititanga	circle
papaku	shallow
Kaihanga	Creator
whakahengia	criticized
rengarenga	lily
tuhia	write
ngoki	crawl
huanui	highway
oratia	live
tahaki	aside
hunanga	hiding
waihotanga	abandonment
whakawahinga	anointing
whakararu	inconvenience
kotingakore	uncircumcised
hohou	peace
whakararuraru	disturbance
tautohetohe	debate
Anatoto	Anathoth
Pani	Pani
Kohati	Kohath
Ahimaata	Ahimaaz
Miriama	Miriam
whakamatauria	try
Hohea	Active
Hahapia	Hashish
Marakia	Malachi
an	an
hononga	connection
potaea	cap
Tiwhi	Tiwi
Timiri	Zimri
Parete	Paret
pahau	beard
kaiwhakamarie	comforter
Ahitupu	Ahitupu
peinga	drive
Maharatia	Remember
torere	abyss
Tikiraka	Tikkurila
kaikopere	archer
Harara	Harad
Amarama	Light
Eripata	Eliphaz
Hete	Hat
Enoka	Enoch
pakau	wings
Ekerona	Ekron
Hohanana	Johanan
titaha	slant
maramara	light
poroka	frog
mimiti	suck
Totoro	Stretch
tumanakohanga	hope
Erangi	Good
harakoa	happy
matimati	finger
uku	clay
pararutiki	paralysis
Hamora	Hamor
kaiwhakapae	accuser
Haruki	Haruki
kaiarahi	guide
poutoa	completely
Ihipohete	Egypt
kaitakitaki	avenger
opehia	crowded
Karea	Karelia
Neputaraarana	Nebuzaradan
whakarangona	listen
kaitutei	watchman
kuiti	narrow
hopukina	arrested
whakahoroa	destroy
ohaoha	economy
whakaoti	finish
whakaotia	finish
Tirohia	Check
whakawhiwhi	grant
muranga	fire
Ierupaara	Jerubbaal
whakawhiwhia	awarded
hiahiatia	needed
putake	root
raia	rice
whakawateatia	be released
tunu	cook
pounamu	bottle
Whakahokia	Return
kohuru	murder
whawha	four
kaipatu	killer
kakama	quick
taunga	landing
pahure	pass
Whakaaroa	Think about it.
toka	rock
Pahuru	September
Mahanaima	Mahanaim
Petehorono	Beth Horon
Kepa	Kepa
whawhe	hand
Nepo	Nebo
koroheketanga	old age
Huhai	Huhai
Iro	Dog
Mahari	Maybe
Peria	Perea
tangohanga	withdrawal
whakatoea	leave
Whakawhetai	Thank you
Netaneere	Nathaniel
Kerehoma	Gershom
Uha	Usha
Mikaera	Michael
Teiere	Tea
huia	take off
Ketere	Kettle
Heperi	Heber
Mata	Face
whakapikoa	bend
Rahapa	Rahab
moata	early
homa	home
kauae	jaw
nganga	gnat
whakatohungatanga	dedication
pateri	battery
pepeha	proverb
taupa	taupe
tuhea	wasteland
tawhitotia	outdated
whakatuwheratia	open
mira	mill
toronaihi	sickle
kikorangi	blue
tukituki	crash
Petuha	Festus
Anania	Ananias
Anaru	Andrew
kaiwhakarongo	listener
whakaungia	be strong
anaterope	antelope
huakore	useless
taiawhiotia	surrounded
whariki	carpet
rarahi	highway
tuhituhinga	writing
manakohanga	preference
Taituha	Titus
ranea	enough
matao	cold
Henakeripi	Sennacherib
Remaria	Remalia
motuhake	special
whakaponohia	believe it
huaki	attack
hura	open
tumuaki	principal
Hana	Hannah
karakiakore	irreligious
kakai	food
tumanakohia	expected
whakapawera	trouble
wharikitia	spread out
Kauaka	No
horoinga	washing
Kireari	Gilead
hina	gray
akiri	throw away
Akuanei	Now
whenu	thread
Haironi	Sidon
kaiponu	stop
pokanoa	interference
rewenatia	leaven
wehewehe	divide
whakairi	hang
Ahataroto	Ashtaroth
Iohereke	Yosef
Heremona	Hermon
Aroere	Aroere
Haratiera	Salatiel
kopaki	envelope
Iatere	Yasser
purenga	purification
tauanga	statistics
Keni	Kenya
tuarima	fifth
Tote	Salt
haereerenga	travel
Erietere	Eritrea
Tehiere	Tehiel
tuawhitu	seventh
Hepatia	Hephaestus
Repaima	Giants
Rakono	Dragon
Apinarapa	Abinadab
Etere	Ether
Teraha	Terah
Opira	Ophir
Taramuna	Tamarind
winika	vinegar
Makarini	McLean
tikaokao	rooster
tautoko	support
metararahi	honor
Apera	Apple
Kiano	Before
muka	face
pahuatanga	robbery
hiawero	tail
ngira	needle
whakaki	fill
anuanu	cold
kopania	group
Tuhituhia	Write
kopia	copy
whakapuaretia	open
kaikokoti	harvester
TE	THE
Taua	War
Korerotia	Tell me.
kuihi	goose
Tamati	Thomas
taronatia	hanged
Kuhi	Kushy
tohatoha	distribution
tahaetia	stolen
purepure	spotted
Kehati	Gehazi
apa	apa
tauhiuhi	sprinkle
kiki	full
kaihomai	donor
titaritaria	scattered
maminga	trick
whakatikatika	correction
re	return
taumau	engaged
kamura	carpenter
tukia	hit
peara	pearl
tito	composition
momotu	disconnect
hekenga	migration
Nopo	Nope
Tu	Stand
pari	cliff
whakakingitia	be crowned
whakahaurangi	intoxication
ea	air
hihopa	hyssop
potiki	small
hikitia	postponed
paparinga	cheek
minaminatia	desirable
tahuti	death
Paratirai	Brazil
maripi	knife
tapatapahia	chop
ro	rain
Parana	Paran
kainoho	resident
kaupae	step
Kihona	Gihon
Mauria	Carry
tuiri	shaking
whakaririka	endure
whakamanawareka	satisfaction
uiui	question
iriiringa	baptism
Hurama	Hurrah
Araha	Arah
Taporo	Tabor
Mahara	Memory
Kerehe	Gedeshe
Repiri	Lepiri
Koko	Koko
Ieraia	Jeremiah
tuaruatia	repeat
Peraia	Peraia
minitatanga	ministry
Tikiri	Tigris
Pirika	Felix
Harimi	Harim
Apihu	Apihu
paraharaha	pan
Kerehoni	Geroni
Oronana	Oronana
Rekapa	Recapa
heua	shave
Topa	Zoom
Meatia	Done
ngawha	hot
Hanana	Hanan
Paana	Money
whakakingi	to reign
Temana	Teman
Rameka	Ramek
hamu	search
Ikariote	Iscariot
Petani	Bethany
rekereke	heel
Merekihereke	Melchizedek
Hakai	Fight
wana	child
Kepara	Kepara
pokepoke	dough
aramona	almond
tara	dollar
rupeke	lump
ngata	snail
taumarumarunga	shadow
Hokona	Buy
uaina	wine
Natari	Wait
Akaripa	Agrippa
whakapeau	to be careful
kutukutu	worm
kuhu	enter
kaokao	crow
Whakatata	Approach
waikore	waterless
Ripira	Liberia
whewhe	boil
paraire	bridle
ngoto	deep
Retini	Rent
korenga	failure
mataaratanga	watch
Iehoiakini	Jehoiachin
kataina	laugh
Hinomo	Hinnom
hatepe	step
Arapi	Arabic
whakahoutia	updated
nekehanga	movement
koingo	longing
Ahakerono	Ashkelon
Maua	Found
Mikimaha	Michmash
whakapau	spend
peneitia	like this
mutungakore	infinite
tawaia	ridicule
Whakahonoretia	Honored
whakatapunga	sanctify
Inoi	Pray
Apirama	Abiram
Kitirono	Kitron
kopiona	scorpion
whakawhiua	be punished
Karangatia	Call
Patehepa	Bath
akiaki	urge
wh	p
noatanga	freedom
tai	tide
Rere	Run
hao	catch
whakaahuatia	describe
whakapohehetia	deceive
maumauria	waste
whakahihi	pride
Atere	Travel
Mekiro	Megiddo
Teropehara	Teropehar
Uti	Small
Petuere	Petuel
Piriha	Bilha
nonamata	forever
whakaangahia	turn around
onika	onyx
roha	expansion
Hanani	Hanani
Ietere	Jether
Ere	Game
Hanunu	Hanunu
amohia	carried
Erihu	Elihu
Netopati	Netophathi
whakaekenga	attack
Hori	Hori
Kenaha	Kenaz
Reuere	Reuel
Arame	Aramaic
Rerana	Relan
Iapeta	Japheth
Hanaparata	Sanballat
Kehena	Hell
whatiwhatinga	broken
KO	WHO
Neria	Neriah
whakao	complete
awha	storm
tauhiuhinga	sprinkle
Timinata	Timinata
Tepora	Deborah
Paranaarama	Paranaarama
Mamere	Mamre
whakatoru	three times
pokiha	fox
kohikohinga	collection
Ietoro	Jethro
roma	Rome
Wahati	Time
iro	dog
Toara	Toara
huhu	worm
katua	trunk
ohanga	economy
tararua	two-headed
Ratana	Rattan
Peretehatara	Belshazzar
huatahi	only child
tapahanga	cut
tetea	tooth
poti	boat
kaiwhakamate	killer
parangia	beggar
whakakino	to insult
kohu	fog
taumautia	committed
whakawhirinakitanga	trust
mahu	smoke
poroporo	bracelet
hurihanga	revolution
korikori	movement
momo	type
whakakorikoria	stir
Topete	Tophet
taurite	balance
rironga	loss
whakatoinga	resistance
kaiwhakaara	creator
whakawhitia	transfer
whaowhao	engraving
whak	talk
rata	doctor
hangai	make
Mawehe	Separate
whakawha	fourth
purero	play
Huihuia	Gathered
whakapanga	lay down
huakina	attack
whakapakari	strengthen
waka	car
uhungatia	mourn
takiritia	thrown
kongakonga	fragment
kautia	empty
unahi	scale
Whakaaturia	Show
toua	dip
karangarangatia	call
ng	of
whakataki	introduction
ngingio	burn
hama	hammer
Tiakina	Protect
Tonoa	Request
tuturi	kneel
rara	frog
whangainga	feeding
Nawai	Nawai
raweni	raven
whakatohungatia	ordained
whakateka	lie
kaikauwhau	preacher
wawetia	quickly
Akaia	Achaia
porangi	crazy
kaikorero	speaker
takatu	get ready
Inaianei	Now
titorehanga	heresy
whakamine	gather
Aporo	Apple
Hamama	Shame
Amihuru	Eleven
Ehuru	October
Rehopo	Rehoboam
Araia	Road
Tepania	Spain
tapokoranga	introduction
Ietereeri	Jezreel
Kore	No
Imere	Imer
Hekania	Shekania
Muhi	Mushi
Eparata	Ephratah
Karami	Caramel
Perekia	Belgium
papahoro	floor
tuawaru	eighth
Teparia	Teparia
Iohanana	Johanna
Eriere	Ariel
Ariere	Ariel
ei	yes
Miro	Thread
Hopara	Explore
Rotana	Rotan
Hapata	Sabbath
Putu	Boots
Erihapeti	Elizabeth
whakarima	fifth
Kaara	Card
Parapa	Barabbas
Tohungia	Please note
kamo	eyelid
kairui	sower
tuteia	spy
Ripono	Reply
ngaunga	chewing
kaiwhakainu	drinker
huka	sugar
tongitongi	small
kupapa	neutral
whakina	confess
taumarumarutanga	shade
Taukiri	Identity
pururu	dirty
ahunga	direction
kotingotingo	speckled
ohooho	shock
namu	mosquito
pokai	surgery
tapawha	square
toromoka	zipper
whakamaramatia	explain
whakamarumaru	protection
Anaka	Only
takatakahi	struggle
wahinetanga	womanhood
taniko	fringe
poro	log
whakatarewa	suspend
mataati	watch
Anakimi	Anakim
tahatika	beach
ketekete	surprise
tainga	birthday
atiutiu	wanderer
Whakarongoa	Listen.
Kaiapa	Coffee
kirika	fever
haeretia	go
motumotuhia	broken
Arauna	Araunah
ahea	when
kikokore	thin
takotoria	lie down
Hore	No
whakorekore	without exception
pare	park
Hepena	Shebna
Kariti	Crete
Hohoro	Hurry up
poroporoaki	goodbye
atawhainga	kindness
inoinga	prayer
nge	smell
pikau	pack
Toraha	Torah
whakaakoranga	education
tauhou	stranger
whakakorekore	rejection
whakawaia	be tempted
whakaware	lazy
Pineamini	Benjamin
kutikuti	scissors
tutakitanga	meeting
paitia	good
pahuhu	smoke
kopiko	curved
atou	our
Whakaritea	Prepare
whainga	goal
kaiwhakahauhau	speaker
kuku	snail
angiangi	thin
parepare	defense
tarere	stream
Ih	Yes
Haunga	Except
whakamutu	stop
Kupu	Word
kuru	crush
atea	space
whakahoa	friendship
whakariterite	preparation
peheatia	how is it
whakamaoritanga	translation
whakataua	decided
wehewehenga	division
ekengia	ride
uaki	open
Hironi	Shiron
Ono	Six
Kera	Kera
Herehe	Heresy
whawhaitia	fight
Horema	Horemhea
Rina	Rina
Maakati	Market
Hekonia	Jeconiah
Harono	Sharon
tiakanga	protection
Iehohanana	Jehohanan
whakamahi	use
tokoono	six
Takuru	Takuru
Iakini	Jachin
Itihara	Crime
urikore	childless
Tekoa	Tekoa
Haira	Hyder
Petareere	Bezalel
Nahahona	Nahshon
rat	rat
whakatane	male
Nahaha	Nahaha
Kereti	Crete
kaiwhakamahara	recorder
koronete	cornet
Kiti	Kit
Ierohama	Jeroham
Atamawete	Atamawete
Itai	Itai
kapohia	snatch
utuhia	paid
Potora	Potora
Timina	Timina
Ieuhu	Joshua
Iopapa	Jobab
Pereke	Brick
Arapahata	Arafat
Kuhu	Kushu
Meheke	Mezeke
Heta	Seth
Makera	Makera
Rapi	Rabbi
poroa	cut
Piri	Close
tauwhanga	gallery
tatarakihi	tartaric
paopaongia	rejected
whakamanawa	breathe
marino	calm
maharakore	forgetful
Hiurharama	Jerusalem
Pumau	Permanent
kohanga	nest
ngaki	cultivate
pakinga	crash
Mireka	Milk
Herepia	Herepia
Karamiere	Carmel
Rehumu	Rehum
Nehemia	Nehemiah
werawera	sweat
rupi	ruby
waikura	rust
puapua	flower
puhia	fired
kaia	eat
Whakaputaina	Published
karaihe	glass
pua	flower
kapiti	crack
whakanoa	normalize
kaiakiaki	driver
whiwhiwhiwhi	income
whakawhero	harassment
wiwi	squirrel
maiangi	wind
whakamaharatanga	reminder
kaiwhakawhanau	midwife
whakawhanau	childbirth
tiwerawera	fever
whakapiri	contact
inamata	instant
Meripa	Meribah
whakapaenga	siege
tuatea	empty
whakiia	confess
Whakapaia	Prepare
whakamaha	expand
rawakoretia	impoverished
otereti	ostrich
Anga	Shell
Eterei	Etrei
reparo	leopard
Perehatara	Belshazzar
perira	beryl
Mihaera	Michael
kaiwhakaahua	illustrator
kaipupuri	owner
whakatahuri	convert
pongere	pong
patata	potato
toko	toko
moremore	hairy
Kirikia	Cilicia
Kaiperu	Cyprus
Mara	Mara
Kamaka	Rock
tatatia	close
pongaponga	nostrils
Pikiri	Pikiri
iri	hang
Tokorua	Two
hikaka	excitement
puao	dawn
whakahekenga	reduction
terapimi	teraphim
Whakahaua	Command
matapuna	source
Menaheme	Menahem
nonaianei	today
herekore	freedom
tahitanga	unity
whakaaroaronga	meditation
Neko	Neko
ira	point
whakaranu	mix
pukuriri	angry
whakatohunga	dedication
Puritia	Hold on.
totohu	sink
tautokona	support
whakahauhau	encouragement
Teharonika	Thessalonica
whakapeaua	banish
whakariharihangia	disgusted
arumia	follow
haukotia	interrupted
ngare	message
koikoi	spike
whakatutaki	confront
maeneene	smooth
wae	step
whakatara	curse
whakaparahako	insult
Akaka	White
oro	sound
whakahouhou	update
mohiotanga	knowledge
whakateiteitia	elevate
tohungatanga	expertise
tapaenga	sacrifice
whakamaro	expand
kokopi	pliers
ikeike	high school
awhiowhio	tornado
tuki	hit
Kepere	Kepere
pana	push
kato	pick
whakamatenga	execution
tapatapahi	chopped
Apere	Apple
Moreke	Moreke
Kemoho	Chemosh
whakaanga	turn
porotaka	round
Arapia	Arabia
oatitanga	oath
Hunami	Shunammite
mahangatia	trap
whakawai	test
onaianei	now
kaiwhakato	planter
takitahi	individual
marire	calm
Koriniti	Corinthians
Taramono	Salmon
Aparono	Abaron
matamuatanga	birthright
Opora	Oprah
Penuere	Penuel
Etama	Etham
Akupu	August
Ata	Image
Heremia	Jeremiah
Erioenai	Elioenai
Mareha	March
Kehuru	Autumn
Uri	Uri
Ihimaeri	Ishmael
Himea	Himea
Ierameere	Jerahmeel
Ihi	Ishi
Hoha	Boredom
Etana	Ethan
Ahaia	Achaia
Kipeoni	Gibeon
Tapara	Tapas
Hewhere	Where?
Eriahapa	Eliasaph
kaiwhatu	weaver
Aturama	Aturama
Kiripoa	Gilboa
Ahoripama	Oholibamah
Temani	Germany
Arana	Aran
Tipeona	Tibeon
Hamaha	Shame
Epara	Ebara
Araki	Road
Kitimi	Kittim
Tupara	Tupala
Iarere	Jared
Enoha	Enoch
Tuhituhi	Writing
akoranga	lesson
Perehepura	Beelzebub
tuapora	elder brother
Iapini	Jabin
Ehetaoro	Eshtaol
Iaramuta	Yarmouth
whakananu	mix
NGA	THE
parihi	parish
Petahaira	Bethsaida
korokoro	throat
wawahanga	division
titohea	what is it?
nama	debt
auetanga	lamentation
whatinga	break
Orepe	Orep
purehurehu	moth
tauarai	curtain
whakatakina	be removed
Onana	Onana
Akana	Akan
whakahekeheke	slow down
Tiripa	Street
Pinui	Pinui
kopuku	knot
kaiwhakawehi	bully
karapoi	group
hiroki	skinny
Toana	His
Huihui	Gathering
whatiwhatiia	broken
kaiota	chef
wheriko	lightning
hahapa	jasper
hapaira	sapphire
tuarongo	back
Pirihitia	Palestine
oroko	open
warewaretia	forget
Kaikauwhau	Preacher
whakamarara	scatter
topito	top
Pihika	Fish
makuku	moisture
whakanuinga	celebration
whakapotoa	shorten
paheketanga	depression
Iapoko	Chapter
Kareheparenea	Kadeshbarnea
koni	rabbit
Kainga	Home
mamingatia	be deceived
tahurihuri	turn around
patipati	applause
Hinara	Shinara
arita	aritha
Raorikia	Laorikia
kokoru	bay
Ataahua	Beautiful
utanga	cargo
Meria	Mary
mokowhiti	space
pakarukaru	fragile
tetaraki	tetrad
patuki	knock
Tepene	Stephen
Koroniria	Cornelius
omanga	run
karaunatia	crowned
atuakore	godless
henua	country
whakapiko	bend
ngi	fire
tapepa	newspaper
hue	color
uhia	cover
kaitahu	burner
haupuria	guard
hereherea	prisoner
kohao	hole
ripekapeka	butterfly
huanga	result
whakataimaha	burden
ho	yes
whakamarokia	stretch
Whakatakotoria	Set it up
otinga	solution
tihore	peel
Matana	Matana
rikiriki	small
toitu	right
takare	ready
Piripai	Philippi
whiriwhiringa	selection
oa	good
kat	cat
kiore	mouse
Urimi	Urim
Kehuri	Change
Raihi	Rice
koroke	crocodile
kaikutikuti	barber
Ateka	Aztec
honikoma	honeycomb
pokaikaha	chaos
whakakoi	sharpen
parakimete	blacksmith
Tepoimi	Teboimi
Peteawene	Bethany
ti	tea
whakaaetanga	agreement
orokohanganga	creation
kaikaranga	caller
moka	bit
whewhera	open
whanuitanga	width
p	p
rukea	abandoned
Pahemata	Persian
Ehiono	Ezion
hamamatanga	shouting
pekanga	branch
Apeke	Ape
Karanga	Call
whakaoatitia	swear
whakamaharatia	remind
whakataimahatia	burdened
Hihaka	Sisera
kairapu	finder
turekore	illegal
kaiparau	farmer
whakahinga	fall
naianei	now
tinihangakore	honest
kurua	crush
Hari	Happy
Karatia	Galatians
whakakorikori	stir
matemate	death
takikotahi	one by one
whakaata	mirror
hongi	smell
huhua	many
reokore	mute
kahaki	kidnapping
inumanga	drink
Taanaka	People
Kiriataima	Kiriathaim
Ripini	Ribbon
Ahinoama	Ahinoam
kakano	seed
marau	fork
kouto	you
Otoniere	Othoniere
Teraia	Teraia
tokowaru	eight
Raarana	Ladana
paunga	expiration
hahau	stroke
whakakiki	persuade
Ataroto	Ataroto
Maono	Six
Rekeme	Rekem
Iamini	Yamini
Rame	Ram
whakatatanga	approach
Mehopotamia	Mesopotamia
Pereti	Plate
Whakatapua	Sanctify
Hepania	Spain
Matitia	Matia
awhio	whirlwind
pakaruhanga	breakdown
tatai	count
Keroro	Keroro
Atareere	Atareere
Ihiia	Ishiya
Terimoto	Terimoto
Tahatiere	Seagull
Perete	Plate
Apietere	Abiezer
Herete	Heredity
titia	pin
Maha	Many
Uhu	Uzu
Kirikahi	Kirikahi
Hawira	Havilah
Iawana	Javanese
Matuhara	Crime
Maharareere	Maharaleere
Erimereke	Elimelech
Nekinoto	Nekinoto
Mikitama	Miktama
Arumia	Follow
Heroriaha	Herodias
pihoihoi	sparrow
hiainu	thirst
Tepuru	Table
Teepe	Door
Taere	Late
Terira	Delilah
Tiporo	Zipporah
taiawhiotanga	circuit
pakarutanga	breakdown
Mihipe	Mishpe
Ripekatia	Crucify
whakakahoretanga	denial
hiki	lift
Ohana	Ohana
Natanahira	Nathanael
takekore	unnecessary
komuhumuhu	whisper
hauraro	subtitle
Huhi	Breathe
tiro	look
Eperemereke	Ebed-melech
Tahapanehe	Tahpanhes
whakahianga	ridicule
whakawairakau	manure
mitimiti	lick
Waiatatia	Sing it.
ramarama	lighthouse
kout	short
patupatua	beat
Naera	Nile
hamunga	hunting
puhake	overflow
marutanga	injury
whakangaueue	shake
Mona	For him/her
titaritari	scatter
kirikiri	sand
whakapania	send
tihorea	peel
pakaka	brown
manitareki	mandarin
whakatutukitia	accomplished
momonatanga	obesity
Makapera	Machpelah
Kana	Ghana
Pikiwai	Pikiwai
Meremoto	Meremoth
Pahata	Pahat
Pepai	Paper
Paroho	Paroho
kaihao	fisherman
Poropiti	Prophet
katanga	laughter
ngao	taste
whakaraneatia	expand
tuawhenua	countryside
kaiwhakawhitiwhiti	communicator
hokohokona	trade
hokohokonga	trade
hoe	paddle
Ohoripa	Oholiba
wirou	willow
oke	okay
kutu	worm
Ahira	Ahira
Whakanuia	Increase
konatunatu	think about it
emerara	emerald
takiruatia	double
Erimi	Elim
tarawa	thorn
oraora	lively
whakawiringa	contraction
amene	amen
ngana	try
haka	dance
pepeke	insect
kimi	find
ngotangota	small
Paarapeoro	Paalpeor
kaika	fast
IHOWA	LORD
pokepokenga	mixing
whakamahinga	use
hamua	sweep
hahani	joke
ngakia	cultivate
Apipi	Apipi
totitoti	limp
Whakaakona	Teach
whakawhiu	torture
Ehekora	Eshcol
Hateroto	Hazeroth
Pahi	Bus
kaipokepoke	potter
moea	sleep
hok	hok
pouritanga	sadness
tuheatia	wasted
paramu	plum
punga	anchor
Wahi	Place
Kamariere	Gamaliel
Whakamatea	Kill
Ripeneta	Repentance
mariri	calm
KI	TO
whakapuare	open
whakamanuhiritia	welcome
rekanga	record
Hairini	Cyrene
whakamanuhiri	hospitality
Raihitara	Registry
Ikoniuma	Iconium
kaingaki	owner
kape	copy
ngangautanga	riot
takere	trunk
pekerangi	sky
tarona	hang
kihia	kiss
weruweru	velvet
huatau	elegant
rokohina	lucky
ruaki	vomit
whakatirohia	open
whakarua	double
Ringihia	Pour it.
ohonga	ohon
Erenatana	Elnathan
whakatahe	rejection
whakararo	down
nananga	trouble
Arapara	Arapara
pikaua	pack
Hamari	Samaria
Heparawaima	Hephaestus
whakatuputupu	grow up
mahorahora	spontaneous
Toroa	Visit
ngoikoretanga	weakness
whakahoro	hurry up
apakura	apakura
whakahohoro	hurry up
papaura	purple
miharotia	surprised
tatanga	preparation
ruruhi	old man
wawao	intervene
puaotanga	dawn
atarua	dark
whakaohooho	alarm
uinga	question
puninga	family
Enekeri	Engineer
whakatutehu	protest
Roeke	Room
koperea	shot
Mongamonga	Little things
Whakaarahia	Wake up
hopi	soap
puwhero	red
Piki	Climb
Apopo	Tomorrow
Whakarerea	Leave
ngengere	noise
whiria	braid
karawarawa	scratch
taunutanga	insult
Erono	Elon
ku	my
Whakatikaia	Edit
Whakakiia	Fill in
tupekepeke	jump
wharoro	spread
Tihipi	Tishpi
Kipetono	Gibbethon
Whakanohoia	Placed
Ihow	Ihow
whakamama	lighten
aramuka	sandalwood
ngatata	cracked
whakakoia	confirm
kohurutia	murdered
whakataetae	competition
rukenga	waste
Akuira	Aquila
piraukore	incorruptible
whakaarahanga	resurrection
totika	straight
Whaia	Follow
kaiwhakangaro	destroyer
Kipa	Kip
Peteheana	Bethesda
Himirono	Shimron
Tora	Tora
Petere	Peter
Maruku	Maruku
Tahata	Tahata
Meraioto	Meraioto
Horiia	Horiia
Naama	Naamah
Terete	Train
Atarikama	Atrichama
Peratia	Like
Eriperete	Elizabeth
Taramai	Taramai
tuturutanga	stability
tokonga	extension
hikamora	sycamore
Terahi	Yesterday
Heperoni	Hebron
Amiere	Amiel
amohanga	burden
Teremoto	Train
Heromoto	Heromoto
whao	nail
Koriata	Goliath
kani	saw
Tapua	Closed
Apihaira	Abigail
Hamai	Shame
Raorao	Valley
tokoiti	few
rohi	rose
Eritapana	Elizaphan
Hopapa	Job
Ahio	Ahio
Iotapara	Jotaba
Amahai	Be careful.
tuaiwa	ninth
Ahietere	Ahijeter
kotaha	sling
Uru	Enter
Ira	Gender
Unuhia	Draw
Akaporo	Apple
Pirihana	Prison
Aia	Yes
Rihona	Dijon
Ioketana	Joktan
Komere	Gomer
whika	figure
Himene	Hymn
whakahauorangia	revive
U	U
Enana	This is it.
Okorana	Okorana
Pakiere	Pakiel
Amiharai	Amiharai
Kirioni	Gideon
Apirana	April
Herona	Herod
Tuara	Back
Herumiere	Herumier
Hereuru	Hereuru
Erituru	Eridu
Ioiara	Joiar
Maki	Maki
kowaowaotia	choke
Haramono	Salmon
koera	dog
nani	beautiful
pakoro	bag
ohatanga	greeting
poki	pig
hokonga	sale
kawekawe	transport
whakaruakina	vomit
roko	log
kohukohua	gossip
rahirahinga	large
Eparaimi	Ephraim
Aronona	Aaron
whakamaroketia	dried
haranga	crime
whakaruhi	tired
aroe	aloe
Nikorima	Nicodemus
KINGI	KING
Taro	Taro
nara	see
tauera	towel
paronga	goal
kapo	catch
Hitimi	Hittite
purena	pure
aporo	apple
Wiri	Vibration
ruakina	vomit
Pirirara	Spider
kaihopu	crew
Kemaria	Gemariah
tumatatenga	anxiety
Pakia	Beat
whakateitei	raise
ngunguru	murmur
koropupu	boiling
marenatanga	marriage
ngotea	suck
oioi	suddenly
whakamataratia	be released
kaingakau	lover
kaiwhakarewa	founder
whakatokanga	planting
whakatutuki	achieve
hurori	roll
konatu	contact
Hipima	Hippim
Ereare	Ereare
harotu	lake
harotoroto	pond
patupatu	beat
ongaonga	nettle
Whakatangihia	Play it.
Akoro	Akoro
Paarimi	Education
moa	rooster
houtia	new
matarua	double-edged sword
tatakirua	two
Kenana	Canaan
atoa	all
takirua	pair
whakapoururu	to be sad
Pau	Finished
Hapainga	Departure
whakahaputia	impregnate
kaiwhangai	farmer
maea	rope
Keroraoma	Geraror
ngahue	crowd
taurekareka	slave
tikarohia	right
Toiaripi	Toiaripi
Hahumu	Sigh
oru	wind
mahuri	plant
Patoro	Pastor
kaiwhakatere	navigator
kaiurungi	pilot
paua	paua
Ohora	Ohora
tine	tin
kaiwhakatapu	sanctifier
tutua	fire
kanapatanga	brightness
aohia	aohia
heitiki	hectic
koropikotanga	worship
Ahoriapa	Aholiab
whakaranua	mix
topaha	topaz
harariu	sad
hapira	sapphire
whakaparori	twist
utuutu	pay
Repirimi	Reform
omere	omer
takiri	push
hamumu	whisper
tautahi	single
Purimi	Purim
whakata	rest
Akaki	Akaki
Hamerata	Hamlet
Hetara	Cedar
tinei	extinguish
haoa	catch
rawe	great
mawheto	pink
Hataawa	Hataawa
Kipiroto	Kibroth
turorotanga	illness
unikanga	unicorn
Manaakitia	Blessed
Tumime	Thummim
Aparimi	Aprimi
whakahaurangitia	be intoxicated
kiripaka	quartz
Arema	Arema
whakatarapi	delicate
mumura	inflammation
Noho	Stay
whawhao	scold
ninihi	sneeze
whaiwhaia	follow
toenetanga	yolk
potatutatu	sudden
tataki	lead
whakamaua	wear it
raparapa	sloppy
Arioko	Arioch
iramutu	nephew
rahurahu	care
tuwhanga	distribution
whakamaoritia	translated
Hohi	Hoshy
Ratou	They
ihiihi	excitement
koanga	spring
ngahuru	autumn
kaiwhiu	prosecutor
turituri	quiet
Nahona	Nahon
whaitohungia	recommended
Riana	Diana
Hahona	Jason
ngarue	wave
peheatanga	how is it
notia	strangle
tawhiri	click
Tarahu	Debt
Itari	Italy
Arapiu	Arabic
Matiu	Matthew
Tikiku	Tick
kuwaretanga	ignorance
kaiamo	bear
Peeroto	Beirut
Peeroti	Beirut
wherikotanga	brightness
whakawehia	threatened
teko	tea
makere	fall
kutikutia	cut
keto	stop
Takoto	Lie down
okeoke	cool
hereherenga	imprisonment
kaihuihui	gatherer
whakapataritaringa	irritation
Haretere	Harare
kaihoroi	cleaner
Kiri	Skin
Erata	Elat
ri	see
Heke	Wrong
puhuruhuru	hairy
manawapatia	comfort
rawakoretanga	poverty
ehea	which one
kinokore	harmless
pukutanga	release
houhanga	reconciliation
akiakina	urge
mangumangu	black
rauhanga	strategy
whiwhinga	income
mauiuitanga	fatigue
tikangatia	usually
whakanekehanga	movement
whano	bad
ranga	rank
haupu	pile
Whakaturia	Set up
timataia	start
kaitapahi	cutter
kaiwhakaranu	mixer
Akona	Teach
rikona	deacon
takawaenga	intermediary
karaiti	church
whakatupatoria	be warned
Atene	Athens
haraira	harare
utou	you
whakahemohemo	death
pokepokea	mold
Whitikiria	Belt
ingi	rain
nehenehe	beautiful
whakawarea	judgment
pikonga	bend
inanahi	yesterday
koperenga	shooting
Naioto	Naioto
werohanga	injection
whakapuru	mount
kokiritia	rush
hemanawa	sadness
tene	yes
whakahou	update
tauwhainga	competition
Hoponi	Soap
Hepara	Shepherd
whakatuma	threat
koriri	mold
karapiti	carpet
whakarewanga	launch
paea	stranded
whakararangi	list
mah	oh
kowhera	open
whakapiritia	attached
roro	brain
Arakopa	Argop
Hokoho	Sale
takahoa	partner
whakangote	suckle
kaiwhakapuaki	announcer
whakaemia	gather
Pahurimi	Pahurimi
Nimihi	Nimhi
mitikia	lick
Apiama	Abijam
Hopukia	Captured
hangaia	built
Pono	True
ngateri	scold
Apihaka	Abishag
anatikaraiti	antichrist
Tae	Color
hangarau	technology
atanga	interface
hurihuri	revolution
tikangakore	unreasonable
Kaiu	Kaiu
Teuere	Teuere
Turu	Chair
Ihui	Ishu
Imina	Imina
Kenaana	Canaan
Pekere	Bag
Atarono	Athlone
mauranga	transportation
Terahia	Zerahiah
Puki	Puki
Apihua	Abishua
Kotana	Kotan
Puru	Bull
Kuni	Guni
Paru	Dust
Ahana	Food
Aina	Aina
Tanoa	Tanoa
Ehetemoa	Eshtemoa
Hua	Fruit
Koto	Koto
Hatuhu	Saturday
Repaia	Rephaiah
Eriara	Elijah
Hakiti	Haggis
tarami	tram
Atariere	Atariel
mehuatia	measured
Heromiti	Herod
Rehapia	Rehabiah
taoroa	long
Akaha	Strong
Mota	Car
Meha	Mesa
Hehana	Seshana
Ahuru	Ten
Merepa	Merba
Ahiruru	Ahiruru
whakamaroke	drying
Hamua	Shamu
toreretanga	abyss
Hihoro	Hurry up
Korahi	Gold
Itiri	Itiri
Karameri	Carmel
Huhati	Huhati
Tekoi	Teko
Ahohi	Ahoh
Mehetapeere	Mehetabel
Paarahanana	Paalanana
Huhama	Shuhama
Onama	Onam
Rihana	Lihana
Nahata	Nahata
Katama	Katama
Epa	Yes
Tema	Theme
Reu	Rheumatism
Ruru	Ruru
whakatangata	humanize
Raama	Light
Mitiraima	Egypt
Maharono	Maharono
Areruia	Hallelujah
MEA	WHAT
Aratakiti	Aratakiti
muhore	empty
Tumanako	Hope
kinakitia	be careful
kaikanga	curse
Opoto	Short
Turiharai	Turiharai
raka	lock
Ioiakimi	Jehoiakim
Puni	Camp
purangatia	pile up
houtanga	renewal
torengitanga	sunset
popo	ball
kauhoa	friend
purenatanga	pregnancy
riringa	anger
whakatongia	planted
mahora	open
mangungu	groan
Kuhanarihataimi	Kushanrishattime
aka	ok
Rehi	Race
wi	yes
whakahuihui	gather
Hariri	Edit
Hokora	Sale
Akatipi	Agatipi
pinakitanga	slope
kaukauranga	swimming pool
whakairinga	posting
Taipiria	Typography
matihao	finger
Arimatia	Arimathea
IHU	JESUS
roherohe	border
korere	diarrhea
karapitia	carpentry
piata	market
pakaruhia	broken
huware	saliva
reti	rent
whakakikitia	tighten
whakaaronga	thought
Naamati	Naamathi
Topara	Topara
kaitahi	each
panuitia	read
Iehuri	Jehudi
Rekapi	Recap
Hanameere	Hanameel
Hananeere	Hananeel
whakamakonatia	satisfied
waitohu	sign
Manga	Branch
whakawhaiti	limit
kihakiha	sigh
puremutanga	adultery
Tatari	Wait
Whakaaro	Thought
Inoia	Please.
kaiwhakatikatika	editor
papatairite	balance
haringa	joy
puputanga	eruption
memenga	child
tawhetawhe	rags
koma	coma
whakamoe	sleep
kumine	cumin
Whakatuwheratia	Open
whawhaki	harvest
Horonaimi	Horonaim
matuku	hedgehog
Anana	Pineapple
whakahirahira	important
pokuru	dark
Huaina	Name
rawatanga	treatment
angata	human
tiahotanga	brightness
ami	together
tawhiua	wrapped
maeke	cold
kaiwhakakapi	substitute
whakapakokotia	beautified
whakahenga	criticism
okana	organ
kor	no
huinga	meeting
ateatenga	freedom
motumotu	isolated
arohatanga	affection
whaongia	insert
kawhakina	carry
Keniti	Kent
Harema	Harem
Eratara	Elatara
whakatete	resistance
Heruka	Heruka
Peia	Drive
kopani	close
Miharo	Surprise
kaiwhanga	waiter
Potenai	Potenai
Tatenai	Tattenai
Himihai	Himekai
Henarara	General
Nekora	Necropolis
Kirere	Kilere
Hakapa	Hakapa
Kepira	Kefir
Arini	Ariane
Atakara	Atakara
Matata	Close
Tatu	Tattoo
Hehepatara	Heshbatal
Hataraenana	Sadaraenana
kera	kerala
Roho	Shower
atarau	moon
whakamakukuria	watered
makanga	throw
tukupu	humble
kaihapai	waiter
pama	palm
horahanga	spread
makamaka	good luck
hokia	return
romia	Roman
puremutia	adultery
porohurihia	turn over
whakaururuatia	double-cross
tupuranga	growth
tairanga	height
tamahinetanga	youth
whakatokomahatia	multiply
whatiwhati	broken
Tohara	Crime
Hanoka	Enoch
tongo	morning
hinamona	cinnamon
HE	YES
taimana	diamond
rererua	double
whatua	broken
kerupi	cherub
muia	herd
Kohikohia	Collect
haupapa	frost
koitareke	quail
Mikitoro	Miktoro
Pihahirota	Pihahiroth
Ramehehe	Rameses
Ngaro	Lost
anei	here
Hataka	Hataka
Hekai	Hike
kowhai	yellow
Moku	For me
Whakakitea	Show
topu	ball
arongia	listen
tokoouou	you are welcome
ahipi	asp
taitamahine	girl
Iehuruna	Jeshurun
tahora	layout
Petepeoro	Beth Peor
Kinereta	Kinneret
kopaninga	closure
matawaia	confused
papaka	dwarf
tauraki	drought
autane	brother
whakatarewaina	suspended
poriro	bastard
parea	protected
At	At
kawau	cormorant
whatura	break
titore	difference
kahera	gazelle
Keritimi	Gerizim
Kapariera	Gabriel
whakariroia	be surprised
maikuku	nail
paninga	coating
Tuaina	Sister
tarau	pants
hana	work
hakaputa	exit
tapapatanga	landing
unuhanga	withdrawal
kaitakahi	attacker
toene	yolk
parautia	plow
whakangau	hunt
kairiri	enemy
Inia	India
arataki	guide
tahoroa	fall
taumarumaru	shade
mine	mine
one	sand
ngongo	tube
miri	massage
whakatitiro	look
Mohio	Know
tohetohe	dispute
tahatai	beach
kotahitanga	unity
Aritaku	Aristarchus
Epehi	Ephesians
Arehanaria	Alexandria
Taiataira	Taiataira
Rerepe	Relebe
Tau	Year
porohiraiti	proselyte
Pamapuria	Pamphylia
Patoromu	Bartholomew
Taea	Yes
Karauria	Claudia
Pirihira	Priscilla
Kirera	Gilera
Kimihama	Kimihama
pini	beans
kaiwhakatupu	creator
Rongo	Listen
Mutu	End
kowhetewhete	whisper
ngahau	fun
angaanga	skull
kopeka	copy
puwha	cough
whakangawaritia	relax
Arahina	Guide
kaiwhakatarewa	debtor
Meroraka	Merodach
Iaatania	Jaatania
whakamatapotia	blindfold
ngarea	slang
Mahia	Done
Pararana	Paran
Ararata	Ararat
pepe	baby
awakeri	drain
Nerekara	Nergal
titorehia	cut off
Arapaha	Arabic
heketanga	migration
uiuia	interview
Paarahepupa	Paalazebub
tuhene	excess
tahua	menu
whakapouritanga	depression
ore	no
whitingia	cross
reta	letter
kinga	king
Mauiui	Sorry
paweratanga	fever
whe	where
Tahuna	Burn
Whakaekea	Attack
whakatenatena	encourage
taiepatia	fenced
karakiatanga	prayer
pakarua	broken
pokia	pig
kakahukore	naked
tang	funeral
kin	brother
Whakamoemiti	Praise
kaipikau	messenger
mui	back
matia	tired
Rupimi	Rubim
Maharata	Maharatha
kaupapa	project
honohono	connect
whakaurua	included
karakiatia	worship
pihopa	bishop
Iwi	People
kaiatawhai	caregiver
Unga	Unga
Aharori	Ashdod
karerehe	black and white
Oati	Oath
Mou	For you
riki	onion
Maumau	Waste
Hehimono	Hesiod
kowhiti	ring
kaiwawao	defender
Whati	Break
whakamomori	suicide
inga	sink
mawhititanga	escape
Tekau	Ten
toremi	drown
piua	slang
kumikumi	beard
wharua	hollow
hikoi	walk
Merapa	Merab
Aitarono	Aitarono
wehikore	fearless
whakahaerea	managed
whakangotea	suckle
Hirawanu	Hirawan
hekore	useless
Arohaina	Love it
tumanakotanga	hope
Paarata	Barat
titoko	support
korupe	roof
arawhata	stairs
rongona	listen
okaka	ok
whakaroaina	delay
iana	her
pipiri	selfish
outou	you
hunipa	juniper
waikeri	ditch
Neke	More
purakau	old man
teta	teta
kutanga	third
Harepata	Harepatha
whakaturanga	establishment
Petemaaka	Bethmaaka
whakahoroma	sterilization
aroa	hallway
Tomo	Enter
whakareretia	abandoned
wepu	whip
whakarangatira	enrichment
Eparati	Efrat
Enerokere	English:
mahea	how
penatia	like that
rereke	different
tutata	close
wetekia	loose
kaka	parrot
whakangawari	relax
matakitakinga	spectacle
hipa	sheep
Oho	Wake up
kaumatuatanga	adulthood
kou	your
waruhia	scrape
Pena	Like this
Ahimana	Ahimana
Hahupu	Hajupu
Haru	Haru
Meripaara	Meribaal
Imira	Imira
Hutera	Hutera
Urama	Ulam
Huhimi	Hushimi
Pua	Flower
Hamono	Hamon
Korana	Koran
Katarimono	Katarimono
Iatiri	Jattir
Tupu	Grow
Heniri	Henry
Hareka	Haraka
whakapapatia	lineage
Meunimi	Meunim
Hatarahuara	Saturday
Morara	Moral
Pahea	How?
Reaia	Reaia
Ikara	Icarus
mapere	marble
ak	ok
Hakari	Feast
Kerupu	Cherub
Mikiroto	Mikroto
Iehotapara	Jehoshaphat
Meheremia	Meheremia
Hamiri	Hamiri
Itihari	Itzihar
Petahia	Petah Tikva
ruritia	survey
moho	mushroom
Tapete	Tabeth
Puti	Put
Peteturu	Petty Officer
Ereaha	Eleazar
Iaraha	Yarah
Atara	Atara
Atupa	Atuba
Harama	Haram
Tohu	Award
Hemiramoto	Semiramis
Uriere	Uriel
tapuwae	footprint
maperi	mulberry
Nepeke	Nepeke
Rani	Rain
whakariro	change
Atai	Atay
Hemaria	Hemariah
Himiri	Shimri
Teriaere	Teriaere
Harari	Harari
Kaaha	Kaaha
Hipekai	Hippekai
Anatoti	Anathoth
Erehanana	Elhanan
Iepuhu	Jebus
Marikihua	Mariquihua
Rehopoto	Rehoboth
Hamara	Hamar
Iaarama	Yaaram
Huaha	Flower
Iokohana	Jokhan
Ketura	Keturah
Hatara	Hatara
Ruma	Room
Mihima	Mishima
Herepe	Herep
Tokarama	Tokarama
kopurepure	sorrel
Kiriono	Gideon
whangangatia	measured
Harariha	Haridwar
Omeka	Omega
Arepa	Alpha
Kititi	Kitti
wawata	wish
whakatitahatia	divide
Nonamata	Never
Tana	His
Paihere	Bundle
kaupare	barrier
whakakini	wink
ouou	you you
puritanga	retention
Hepama	Shebam
Mirika	Milk
horomiti	swallow
ngaruru	thunder
maunutanga	withdrawal
Peraturu	Peraturu
Keheme	Geshem
Horoni	Holland
Pakapukia	Be careful.
Itiere	Ithiel
Tarua	Weed
huamo	swelling
whakaharakoretia	acquitted
hiko	electricity
kota	goat
ruwha	rough
Rekaporihi	Dekapolis
tupunga	origin
Whakatangi	Play
hemi	ham
Kenehareta	Gennesaret
Heteromo	Heteronomy
Hoana	Joanna
tonutanga	continuity
taihoa	friend
Petapaki	Petapaki
Nonaianei	Recently
Hakiaha	Haggai
kowhao	hollow
heihei	chicken
patoto	knock
patene	button
hatana	satan
kokokiko	meat
horohoroa	clean
nawe	you
Matawaia	Matawaia
taruke	truck
taraheke	thorn
tiwhaiwhai	tiffany
Nopaha	Nobah
Apieteri	Abiezer
Harohete	Harosheth
Piratono	Piranha
Hepuroni	Hebron
Aronipeheke	Adonibeheke
manukawhakitia	bewitched
Taperi	Taper
Aramono	Almond
Peteanata	Beth Anath
Peere	Bucket
Enekanimi	En-ganim
Hehai	Hey
Petearapa	Beth-arab
Petehokora	Beth Hokora
Atamono	Atamono
Akarapimi	Agrapim
Iokoneama	Jokneam
Paarakara	Bar
Akahapa	Akahapa
Hiroama	Shiloam
nonahea	when
Meake	Future
tatahi	beach
hautai	Spanish
HURAI	JEWISH
Korokota	Golgotha
inaina	heat
Kaiwhakamarie	Comforter
kaiwhakahe	critic
Ririmu	Rilimu
tutetute	bump
Huna	Hide
matakitakina	watch it
rewiatana	leviathan
whakaitia	be humbled
whakapurangatia	archive
Mate	Death
pekepeke	jump
tapatahitanga	integrity
Wawahia	Broken
peha	such
Karapotia	Carpathia
pakiri	push
whakawhaititia	reduction
hemonga	sleep
Wehea	Divide
tohatohaina	distributed
pukenga	skill
whakawairua	double
wharahi	wide
Tona	His/her
ohoreretia	suddenly
Kerioto	Kerioth
Horono	Horon
ngaehe	noise
tumatohi	warning
pariratanga	rejection
kohukohutanga	slander
ipa	ip
Hohaia	Hosanna
Hamakara	Hamakara
Inumia	Drink
hori	yes
Neherami	Neherami
Uriia	Uriah
pahekeheke	slippery
Konia	Konia
whakangenge	tired
whakarereketia	change
Horoia	Wash
Emanuera	Emmanuel
hupa	soup
whakakopikopikoa	to wander around
pungawerewere	spider
kaikohikohi	collector
kopi	copy
kotikoti	short
mutua	finally
ingo	name
nekeneke	movement
tahoro	hurry
Pere	Arrow
rimu	sea
warou	crane
kaitatau	counter
rukerukea	waste
waipera	viper
Whakama	Shame
whaiti	narrow
Rewiatana	Leviathan
Whakawhirinaki	Trust
whakaruru	shelter
nekenekehia	move
whakakahuria	wear
kopakina	closed
takutai	beach
Wetekina	Untie
taheke	diarrhea
Rimona	Lemon
mahoao	wild
ruperupea	rub
tan	tan
kaiakiko	therapist
henga	mistake
tohutohungia	advised
whakananua	mix
Riro	Win
kairua	double
whakatupapakutia	be killed
whakapumautanga	confirmation
whakapeka	acute
takiwhitu	seven
Arare	Arale
Areri	Areli
Huni	Hunt
Haki	Flag
Iahateere	Jasper
Taraha	Loan
muanga	first
Potiwhera	Potiwhera
Ahenata	Asenath
tauia	counted
maoa	cooked
Moe	Sleep
Tira	Tira
Irara	Ireland
roropi	wrap
whawharua	double
Aturami	Adulami
matangerengere	snoring
takoki	to fight
Wehi	Fear
ekeeke	climb
nonoke	small
haputanga	pregnancy
ama	father
maheni	familiar
kaiwhakangote	nurse
puia	volcano
Pikora	Piccolo
inapo	last night
kohore	fish
haria	take
ruruhitia	old age
tikakatanga	honesty
Peererahairoi	Peerless
Hirimi	Shirimi
whakapoauautia	confused
tohora	whale
hihiritanga	motivation
Apa	Apa
whakatamarikitanga	adoption
Ahawa	Ahava
Harahuru	Harahuru
Tiha	Tisza
Petai	Petai
Aronikama	Aronikam
Matenai	Matenai
Kerita	Crete
Hapetai	Haphazard
umere	shout
repo	swamp
apiti	annex
takuahi	fireplace
karapotinga	surrounding
horonga	collapse
pongaihu	nostril
hare	hare
keteketenga	astonishment
when	when
pokarekare	chaos
marumaru	shadow
Tapatahi	Integrity
mahuta	mahout
hoana	wife
whakaataahua	beautiful reflection
Peteiehimoto	Beth-jeshimoth
pupuru	store
whakakatanga	make fun of
Koa	Please.
mirimiria	massage
pairi	pair
whakatakanga	warning
huaranga	root
kauru	cover
taitamahinetanga	girlhood
hiraka	silk
uho	core
Aturu	Asura
whakahaunga	prescription
amipere	amber
rai	rye
korari	blossom
Hauru	Half
paremo	drown
korara	coral
Ahihamaka	Ahihamaka
kahia	cash
AHAU	ME
TAPU	HOLY
ametihita	amethyst
kapakara	parrot
whakarewaia	launched
Taria	Wait.
pariri	shower
whara	injury
matanui	open
araarai	barrier
honia	honey
Hipora	Zipporah
tumutumu	peak
Paarahepona	Baalshephon
topuni	camp
hakiri	hurry
kumete	stool
Puri	Close
Memukana	Memo
kakariki	green
muramura	fire
Herea	Bound
kaikarakia	worshiper
kakenga	ascent
Whakakahoretia	Rejected
kimihia	search
materoto	abortion
tuitui	sewing
takataka	tramp
pikinga	increase
horonete	hornet
rererere	butterfly
puakanga	outbreak
karangaranga	call
takitakina	to be beaten
whatupango	eye
parautanga	plowing
Hawotohaira	Hairy
whakatakariri	anger
whakamatauranga	test
haer	go
whakaahu	dress
kautanga	collection
tuwhenua	country
whakawhiunga	punishment
auwahine	my wife
kaiwhakariterite	moderator
Aroera	Aroera
Emime	Eminem
whakatari	wait
owa	oh
pekapeka	bat
taaka	duck
taurangitia	guaranteed
nua	new
hapahapainga	sacrifice
More	More
Iotopata	Iodophor
warea	worry
whaioio	funny
Onamata	Ancient
Tuaiho	Old
ahatanga	what happened
turere	travel
MENE	MENE
taratimere	tram
takakino	abuse
Murua	Kill
Epapara	Epaphras
whakai	confirm
Tautoru	Three
whangawhanga	wait
ahere	ah
whakaparoritia	confused
Awene	Awene
Raira	Rail
whakaitinga	humiliation
whakataurekarekatia	enslave
Pononga	Slave
whakamoea	put to sleep
ngarara	insect
whana	kick
minenga	audience
tutataki	contact
Pereniki	Berenice
Raihia	License
Arehanara	Alexander
Kario	Cario
kaitito	poet
Areopaka	Areopagus
huakanga	event
herenga	obligation
Riria	Angry
tupare	tire
Hupita	Jupiter
pahaki	hit
kawei	carry
kauwhautanga	preaching
Pereka	Peregrine
Kakahuria	Change clothes
whakatepe	limit
Matiaha	Matthias
Hutuha	Hussite
Toto	Blood
Miretu	Millet
Toropimu	Trophimus
Eratu	Erastus
Ruka	Luke
Rimaha	Friday
Kauwhautia	Preach
kawhaki	catch
Whakamaharatia	Remember
rurea	shaking
Toi	Art
Peratimi	Perazim
rahiri	rascal
Haea	Tear
Papa	Father
Iharira	Israel
Rihipa	Rizpah
hun	hide
pukoro	pocket
Herekata	Hecate
whakaarohia	consider
mauri	essence
Rotepara	Rotbara
ekenga	ride
kauanga	port
Nonanahi	Yesterday
Tepehe	Steps
Herama	Sheram
whakawiria	twist
Mahue	Leave
poaina	dinner
whakataunga	decision
taki	check
aere	go
ah	oh
ten	ten
aira	air
Ihar	Ihar
kakarauri	twilight
nawai	who
pohewa	imagination
Toku	My
rahaki	rascal
morikarika	sly
ura	fire
whakatangihanga	play
paunatanga	weighing
Tohea	Fight
Hamutara	Hamutara
Etara	Ethar
perea	such
Iwa	Nine
Hena	Henna
mu	fire
Ataramereke	Adrammelech
Mahi	Work
Pirehere	Police
Tikirata	Turkey
Pekahia	Pekahiah
Uakina	Open
peeke	bank
pakipaki	applause
Aranono	Arranon
Iraira	Israel
whakaemi	accumulate
whakahoatanga	friendship
ngangaretanga	conflict
whakamatapo	blind
whakapuakanga	declaration
whaoa	cut
whakapuranga	archive
akinga	life
utukore	free
tangat	man
whakaroto	inside
Karakemihi	Carchemish
Oti	Finished
tekia	take it
whakakore	cancel
purua	closed
Miniamini	Miniamini
Konania	Conan
rikirikitia	slowly
nu	new
tauhi	care
whakapataritaria	provoke
piu	swing
gi	yes
kaihiki	cleaner
pakura	rash
whakatuturutia	established
Orere	Orere
hai	hello
uiuinga	interview
Kiia	Say
tautohetia	controversial
Kai	Food
Arehanera	Alexander
kaiwhakatoi	artist
Ahau	Me
kaiwhakawai	healer
whakamanawarekatia	be pleased
matu	sleep
tongohia	open
Epeneetere	Ebenezer
Petehana	Bethany
wawa	fish
Pehoro	Pehoro
Tuohu	Bow
Eneroro	January
Huneme	June
Noku	Mine
Parati	Prague
teahi	tea
Hoake	Up
whakawiri	squeeze
Hakira	Hakira
whakatenetene	to be careful
onge	rare
Nei	Now
maoritia	natural
iwikore	boneless
whakarangatiratia	liberalize
tiihi	cheese
papatu	flat
whakatuturi	slow down
ni	now
whakawhitinga	transfer
Penina	Peninnah
Whangainga	Feeding
whakamamaetanga	torture
Ponoto	Pontus
Eroto	Inside
kaiherehere	prisoner
wini	win
whakakopa	fold
taraia	cut
kaiwhakahau	commander
Eterahi	Ezrahi
Apara	Apple
riu	valley
tari	office
Aperemehora	Abelmehora
tuatorutia	thirdly
tawharara	tawny
nonga	peace
takirima	five
whakanohoanga	placement
Tipini	Tipini
Kinerota	Kinnereth
kuinitanga	queenship
tia	deer
koara	coral
Tahapene	Tephra
hautope	cut off
Mirikomo	Milcom
Ahatorete	Ashtoreth
kairiringi	singer
maiatanga	confidence
ite	know
matapotia	blind
whakamokatia	be careful
kaiui	lazy
auaka	auau
honorekore	dishonorable
run	run
Petekoha	Pentecost
kaipehi	driver
whakamaori	translation
pouriuri	dark
tatangi	ring
kaiwhakamaori	translator
waihanga	creation
whakapainga	improvement
whakakuwaretia	fool
Tepana	Stephen
Anei	Here
Karara	Color
Utai	Question
Mereke	United States
Erepaara	Elpaal
Tipia	Cut
Ahapere	Ashapelle
Taparete	Tabarete
Hemira	Hemira
Ahariere	Donkey
Hupimi	Huppim
Itirahia	Italic
Keremoto	Keremoto
Aremete	Almete
Hamere	Hammer
Apari	Apricot
Mahata	Mahatma
Epiahapa	Epiphany
Ahiri	If only
Tima	Tim
Haporo	Haporo
Paarameono	Baalmeon
Pirinehere	Prince
Tirikata	Turkey
Iaripi	Yarib
Reheme	Rehem
Hoko	Buy
Naara	Watch
Nearia	Nearia
Hahupa	Hajupa
tokoiwa	nine
Nou	You
katoatanga	totality
Tapari	Tapar
Himioni	Simeon
Parapara	Trash
Tupimi	Tupimi
Otoni	Otto
kaiwhakamahi	user
Hohama	Hohama
Hupaere	Friday
paraipanatia	fry
Erere	Error
Hepuere	September
Tita	Tita
Whiriwhiria	Choose
whakataranga	explanation
Apihuru	Murder
Hekupu	Word
Rara	No
Karakoro	Color
Hamuru	Hamuru
whakangongea	soften
whakamoemititanga	praise
Whakapuakina	Declare
Heminiti	Heminite
Atatia	Image
Uni	University
Pene	Pen
Iapia	Japia
Ipihara	Ibira
Ingoa	Name
Peraka	Barak
Titi	Titty
Apiere	April
Herere	Seler
Maharai	Maharai
Ikehe	Ikeje
Peroni	Peru
Harori	Harodi
Kapateere	Capital
tikinga	collection
Iahopeama	Jashopeamah
Itirana	Italy
Manahata	Manahata
Miha	Miha
Omara	Omar
Napihi	Napis
Ieturu	Jetur
Mipihama	Mibsham
Nepaioto	Nebaioth
Hatorama	Hatorama
Kapatorimi	Cappadocia
Rurimi	Ludmila
Nimirota	Nimrod
Makoko	Makoko
Kainana	Cain
Hurami	Shulammite
tare	doll
purotu	clean
hena	henna
taokete	brother-in-law
Oropa	Europe
kaiwhakatika	editor
Hipania	Spain
waero	worm
kuata	quarter
hakiniti	hakini
KOE	YOU
whakamenenga	migration
Nikoraiti	Nicolaitan
ARIKI	KING
parukore	sanitation
mariao	mario
Akina	Akina
Rewera	Devil
karaunga	crown
aniwaniwa	rainbow
Perekamu	Pergamum
Kairapu	Finder
Whakaharitia	Be happy.
whakauaina	rain
Hikaiono	Higaion
Hohanimi	Hosanna
IHA	IHA
Erutu	Eruth
Ahuareka	Ahuareka
huwha	thigh
Hinga	Fall
Kino	Bad
whakaharitia	be happy
Maru	Maru
Haereere	Travel
kaitawai	critic
Parea	Defense
whaereere	mother
Awhinatia	Help
pinono	beggar
tauranga	port
korihi	korea
Whatiia	Broken
whakatupereru	incitement
Manakohia	Recommended
Remuera	Lemuel
popokorua	ant
Whakamataratia	Start
heia	hey
pukukai	hungry
puputu	confused
nganagare	excitement
kaipapaki	speaker
wanoke	wander
hauwarea	clumsy
titoa	composed
Epaporitu	Epaphroditus
Perahuru	Perahuru
epaina	spinach
Ripirataima	Redemptorist
Riponokara	Rapunzel
Punono	Puno
Taramona	Salmon
Hakirikara	Hachikkara
Peneiaakana	Beniaakan
Moheroto	Moheroto
Hahamona	Hashmon
Makaheroto	Herodotus
Harataha	Harataha
Hapere	Travel
Keherataha	Tomorrow
Ritaha	Retirement
Parehe	Paresh
Ritima	Rhythm
Aruhu	Aruhu
Ropoka	Group
iharaira	Israel
tokotorutoru	threesome
Huhami	Husham
Heteroni	Hesron
peau	bag
Pamoto	Pamoto
Nahariere	Nahaliel
Iteaparimi	Itaeparim
ratu	king
Merara	Merara
Ererara	Elerara
hiu	fish
wherahanga	opening
ruperupe	rufu
Hahapania	Hashpania
Meaha	What?
kaiwhakawhetai	thank you
Amoko	Amoko
Henua	China
Korohote	Corohote
Harohehe	Harohehe
Anaia	Anaia
Haripi	Haripi
Kinetono	Kineto
Hakaria	Hacariya
tapatu	hit
Whangaia	Feed
koronga	intention
kokinga	collection
Pahemo	Past
whakahore	reject
whakatitaria	spread
tunewha	fourth
pereti	plate
kaiako	teacher
whakaunaka	clean up
Utua	Payment
pake	package
whakangahoro	relax
Eriuru	Eliuru
Akimi	Achim
Atoro	Asoro
Apiuru	Apiuru
Ohiaha	Ohiaha
ohomauri	scolding
heparakore	shepherdless
kaukauria	be careful
rihiona	legion
rototia	inside
Tariu	Wait
Haromi	Salome
hapakatani	Sabbath
Eroi	Hero
Whakaora	Recovery
Rupuha	Rufus
parapa	barbara
painaina	burn
Kehemane	Gethsemane
toutou	repeatedly
atawhaitanga	kindness
whakapawerawera	irritation
Heroriana	Herodiana
tokoruatanga	couple
kororo	gossip
rereketanga	difference
Rihiona	Legion
Kararini	Karin
huria	change
ngeri	horror
whakamakanga	warning
keokeonga	keokeonga
Rakau	Tree
poaha	good morning
Nahumu	Nahum
Mereki	Melek
Angaanga	Skull
Whakapakia	Apply
whakakinongia	despise
Tokorima	Five
pahemotanga	passing
tuaritanga	distribution
tina	dinner
whakarakau	to be careful
miniti	mint
Korahina	Chorazin
piriniha	prince
ruruhitanga	aging
Apiata	Abijah
hoatutia	given
kaiwhakahere	executioner
kaitauhiuhi	sprinkler
whakiinga	revelation
whakaherenga	offering
whakahapati	Saturday
hakihaki	search
kaipuremu	painter
tekatia	lie
horohoro	hurry up
repara	rubber
whakakorenga	cancellation
mokomoko	lizard
Whakatahuritia	Turn it around
Mangu	Black
taukiri	opponent
Hipokina	Cover
Paaraperiti	Baraport
Petepara	Bethel
Pura	Puru
kaiwhakamatautau	tester
whakakahokaho	make fun of
Kupapa	Neutral
Apinoama	Abinoam
Anata	Ananta
Pokimi	Pokmon
tokomanawa	two thousand
heunga	shaving
Whakawaia	Judge
Ipitana	Egypt
Topo	Topo
Hepata	Shephat
Peheke	Bag
whakatutu	to stop
whakawhati	to force
Whakatapu	Consecration
whakapaheketia	belittled
whakamaroketanga	drying
horahorangia	be careful
Kihiono	Kishon
Naharara	Naharara
Ipitaere	Ipswich
Pete	Pet
Ipireama	Ibraaam
Hereke	Heredity
Kanaha	Cana
Ianoha	Janoha
Mikimeta	Michmeta
Kiriatapaara	Crystal
Peterakono	Peter
Ahena	Ashenafi
Eretorara	Electoral
Iimi	Search
Iapaneere	Japaneel
Nepetoa	Nephew
Arumine	Arumine
Pohana	Good morning
kongutuawa	river
Petenimira	Bethany
Ramata	Ramat Gan
Repa	Lepa
Ewi	Evie
Hahara	Sahara
iw	in
Aharoto	Aharon
Anapa	Anapa
Haraka	Haraka
Maimi	Search
Mihirepoto	Mihribet
Meromo	Merom
hiwi	ridge
Marono	Deep
rong	sleep
Aronitereke	Aroniseke
Taka	Taka
hoenga	rowing
pokarekarenga	movement
matutu	dry
kaiwhakaae	approver
Takanga	Event
Kereopa	Cleopatra
kaore	no
nohonga	residence
kaitaka	writer
matanuitia	popular
horohoronga	washing
Mihaia	Misha
Kuhua	Put
Kapi	Cover
kanakana	man
paihana	poison
Wareware	Forget
Aketura	August
Matariki	Matariki
papatupu	papatupu
Hiritia	Seal
Parakere	Parakeet
tongi	fertilizer
Tangi	Cry
kakarauritanga	twilight
whakakawa	sour
Tere	Hurry
Pehea	How?
aruaru	follow
hirokitanga	thinness
taharahara	worry
puhaketanga	overflow
whakamoroki	to be quiet
kaikohi	collector
Petehakereme	Bethsagar
ngawhatanga	swelling
Marakomo	Malcolm
Hihono	Connect
haehaenga	incision
Kiriherehe	Kiriherehe
Mepaata	Mephaath
tam	dam
urupuia	buried
putere	power
Rapamaka	Rapamount
Rapahari	Friday
Inana	Inana
karukaru	clothes
keiwha	four
Iriia	Irrigated
tok	tok
hirikore	unsealed
moniania	happy
Whakamutua	End
kaititaritari	agitator
whakaporopiti	prophecy
Koraia	Korea
Morahati	Morahati
Hehaka	Sheshaka
whakaha	breathe
H	H
ngarenga	flower
warewarea	forget
koromaki	swallow
kohamo	humpback whale
houra	soda
kairahurahu	researcher
Hiruharam	Jerusalem
Rongoatia	Solved
manoao	forest
Ngohe	Activity
powhiriwhiri	fan
hirere	sly
ngehe	soft
huhuti	pull
whakapatari	aggravate
Poauau	Stupid
Whakina	Reveal
Turia	Tyre
whakararatatia	tame
pareparea	defense
whakapuke	pile up
Whakamiharo	Amazing
Hiroa	Title
Hapaha	Hapasha
Mahereharara	Maher-e-Harar
whakamanamananga	joy
kaitautoko	supporter
weweru	sly
herapima	seraphim
ropia	closed
Opehia	Oppressed
momoe	sleepy
kaiwhakawhiu	punisher
taupuhipuhi	thorny
whiowhio	whistle
pakapaka	scold
kopiri	squeeze
kaiwhakamoti	destroyer
kaiwawahi	destroyer
pouarutanga	widowhood
kupukore	speechless
whakawhaiahua	beauty
Kaiwhakaahua	Photographer
Maturuturu	Drop
ahe	ah
porokeretia	procrastination
peere	bucket
titiohea	look
kareni	Karen
koroki	crocodile
whango	loud
Whakakahangia	Strengthen
kapia	glue
okiha	oak
puwhenua	spring
kaipauna	reader
whakaaroaroa	consider
whakinga	confession
whakahohonu	deepen
hunuhunua	whisper
koukou	you
orohina	pink
pokurukuru	dark
tahinga	collection
Hurorirori	Twisted
mapu	map
taui	change
pakaha	hard
whakakae	turn on
rurutanga	shaking
Nopa	Nope
kaihi	driver
Naere	Go
raupo	raupo
tokokai	food
kapakapa	butterfly
ruiruinga	earthquake
Hakaopa	Jacob
Nimirimi	Nimrim
Ruhiti	Ruhiti
toke	worm
tamutu	stop
kaiwhakarau	prisoner
poruru	cloudy
gata	enough
korakora	spark
whakahoha	annoying
porearea	disorder
tutakinga	meeting
moke	monk
Ako	Learn
Werawera	Hot
terepini	turpentine
Whakawakia	Judge
tautoro	support
makonatanga	satisfaction
tah	yes
patohe	protest
Whakatokia	Planting
pahuka	foam
Iarepe	Jareph
Roruhama	Roruhama
mamaetanga	suffering
ohaki	oh
taumata	level
mei	may
tupuria	grown
wawae	foot
Ora	Life
Nohinohi	Small
Mataku	Fear
kaitimata	starter
awhitia	embrace
kapono	believe
kaiwhakaari	actor
kiinga	word
hokihoki	back and forth
pumautanga	stability
koputaputa	out of nowhere
Takahia	Step by step
hihi	ray
rou	sink
Hapakuku	Hapacuku
pupuke	pile
kairongoa	pharmacist
whakapakaritia	strengthened
wahapu	harbor
hiranga	importance
pakaritanga	strength
Nekehia	Move
whakawhitiwhitia	communicate
Hireme	Hiram
Arori	Arori
ringiringi	sprinkle
whakatuwheratanga	opening
wateatanga	availability
amitia	amity
rangatria	senior
kohera	kohera
Tuparakaina	Tubarakaina
Mehutaere	Mehutaere
Enaima	Enaim
Potiwhara	Potiwara
nai	now
Tepo	Tepo
pokea	dirty
ohaohatanga	economy
Kareere	Travel
whawhakia	be careful
hake	right
papara	poplar
piupiu	snort
Kerupima	Cherubim
tuia	sew
papahewa	fantasy
mamingatanga	deception
Nuku	Move
Erona	Elon
Peeri	Beer
teriuma	resin
matapotanga	blindness
Kaiwhakawa	Judge
Anera	Angel
Hawe	Half
Tirara	Tilar
Arioka	Arioch
Amarapera	Amber
enua	continent
whakamararatanga	dispersion
Papera	Papal
Makoka	Makoka
kare	no
whakamanamanatanga	pride
nuka	move
ponongatanga	slavery
hutihutia	pulled out
Noaria	Norway
Kahipia	Caspian
Aparahaki	Aparaji
takot	fear
whakatakotoranga	format
Hapaia	Skip
kawai	only
Terehareha	Fast
Teremera	Telma
Ami	Ami
Tepaimi	Time
Pokerete	Poker
Tarakono	Dragon
Taara	Dollar
Hoperete	Hopeless
Hotai	Hotei
Hatipa	Hatipa
Netia	Netia
Tamaha	Dinner
Parakoho	Parakeet
Mehira	Mehira
Hakupa	Hakupa
Pakapuku	Pakapuku
Kahara	Crime
Haramai	Haramain
Repana	Lebanon
Parono	Baron
Keroho	Keroho
Tapaoto	Tapato
Hopai	Good
Hatita	Hatita
Henaa	Sena
Kapa	Team
Netopa	Netophah
Takai	Wrap
Heremai	Here we go.
Tapai	Cover
Miamini	Miami
Tereme	Door
Hotapara	Hot springs
Mitirerata	Mithridates
ngonge	weak
Haurana	Hauran
Terara	Terada
ponapona	ankle
kotititanga	deviation
ere	loss
aturia	welcome
whakaono	six
Whakaangahia	Apply
Whakapaea	Accusation
kaimuru	eraser
poupou	pillar
whakahaereerea	management
purata	average
ngarungaru	confusion
pereni	banana
Hewene	Shewene
takaoriori	play
whakawhitiwhitinga	communication
Miniti	Minute
kaoa	coral
kaimono	kaimono
Arawara	Arawa
kaihoe	sailor
komaru	umbrella
tomokia	enter
whakamakia	be careful
pukepoto	short
Pekoro	Pekoro
Minamina	Minami
whanako	theft
han	hello
orohia	polished
kaiwhakaheke	traveler
rero	red
katohia	cut
paki	sunny
Paku	Paku
whakataukitia	proverb
parira	bird
Ehekiera	Ezekiel
pupuku	pile
Iokepete	Jochebed
Ohara	Ohara
Iemuere	Jemuel
whakararangitia	listed
pukorero	speech
Miho	Miho
tarautete	trousers
whakawhaiawhitia	to be shared
whakah	open
kaiwhakairo	sculptor
NA	THAT
ruinga	sowing
ruiruia	shake
pat	pat
NEI	NOW
akete	agate
rikuri	quick
kaituhi	writer
takapu	center
mahina	month
pouarutia	widowed
whakatupukino	abuse
tapakuha	bride
hom	home
takitaki	check
whakariteritenga	arrangement
hotu	fruit
atiati	ati
auta	car
tek	yes
wahinetia	woman
Erietera	Eliezer
on	on
whakakiinga	filling
korianara	coriander
papanga	fabric
aratakina	guide
whakatotoka	frozen
Taupokina	Cover
ihowa	Lord
whakamarokanga	explanation
awhiotia	windy
awangawanga	worry
raweke	manipulation
moroki	morocco
taiepakore	without walls
Nihana	Nisan
Terehe	Speed
Pikitana	Picton
matenuitanga	passion
Harapona	Harpoon
ngarotia	lost
ohoohonga	excitement
Nona	His/Her
Apotoro	Apostle
porahurahu	puzzle
whakatiki	limit
ruhatanga	exhaustion
Tapera	Taberna
whakamohio	inform
rane	frog
Whakangaromia	Destroy
raneatanga	sufficiency
ngangautia	chewed
whakamahu	warm
kakati	close
huwhare	February
whakapaho	broadcast
punehunehu	black and white
Whakaminea	Gather
Aroha	Love
Hiriona	Sirion
pakeketanga	maturity
haumaruru	safe
hehe	hehe
whenuku	cold
karaehe	class
nehu	burial
whakarino	iron
whakaparahi	apologize
raima	concrete
taina	brother
ino	bad
whakauruurua	double-entry
whakamaia	be careful
Awimi	Awami
rohea	border
Tetahi	One
whakapaheke	to collapse
whi	whine
rawenakore	unsettled
rin	body
hupou	hair
heroni	heron
perikana	pelican
wani	water
koekoea	kokoeya
kaiaia	food
ahipare	firefly
whakapeautia	be expelled
kinitia	beautiful
whatoro	spread out
Whakamotitia	Destroy
matapoporetia	worried
kowheratanga	opening
Kotia	Cut
Kurekora	Kurekola
whakatenatenangia	encouraged
whakaururua	double entendre
hinana	sini
Urai	Rain
TEKERE	TEKERE
tareka	tarek
tangoro	tangoro
hoahoa	design
ran	river
matikuku	fingernail
hunua	buried
maharahara	worry
parenga	resistance
paaha	pass
whakangaua	hunt
whakaingoa	name
tuk	stop
ene	yes
whakakanapa	shine
Hirekere	Hilekere
Meretara	Meridar
Arakipu	Archipelago
Onehimu	Onesimus
Rangatira	Lord
Tautangata	People
whakaunga	connection
tuhonohonoa	connection
tataria	sift
Kapatoro	Cappadocia
pihinga	curve
whakamatara	to explain
Karane	Grain
weranga	burn
mounga	mountain
Tapaea	Offer
Whakamine	Gathering
kotakota	lime
wititia	wheat
Roka	Rock
Tapita	Tabitha
Harona	Sharon
hereheretia	imprisoned
ripenetatia	repent
whar	room
Wetekia	Untie
whakaporeareatia	disturbed
tomonga	entrance
Ponotia	True
Take	Reason
tupeke	jump
rehere	prison
Pupiriu	Publius
urungi	steering wheel
whakatatutu	sacrifice
heramana	sailor
kahakihakina	kidnapped
Po	Night
Akuhata	August
Huriu	Change
Emepara	Emperor
whakakapia	replace
Tereturu	Speed
Ao	World
whakamanumanu	to be angry
ringatia	hand
ingoakore	anonymous
takitahitia	individually
ruke	waste
ihupuku	risk
Aho	Aho
werowero	piercing
aronui	aron
manganga	confusion
tupeketanga	jump
whakaponotanga	belief
Kenekerea	Genghis Khan
tui	stitch
NGARO	LOST
ATUA	GOD
whakakorokoroa	calm down
whakauria	support
Whiti	White
Maihia	Thank you.
Pirikia	Phrygia
whakararua	inconvenience
horoa	give
Raikaonia	Lycaonia
Pihiria	Pihiria
kaimakutu	witch
Herekiu	Heresy
Papaho	Flat
uakanga	opening
Whitiki	Belt
Akapu	Akabu
Pinikia	Phoenicia
Heroti	Herod
Tiopira	Theophilus
Rimitiriu	Demetrius
karo	fight
apohia	take
Oku	My
Onehipora	Onesiphora
Ana	Cave
wah	wow
kirikau	naked
R	R
Kitaima	Kitaima
Paratiere	Pratiere
tatakirau	each other
toputanga	registration
Moti	Motor
whakatupehupehunga	reprimand
Kokiritia	Hurry up.
Ngiha	Fire
whakapingoretia	be restrained
Kopo	Body
whakahauputia	be encouraged
tuakina	split
tauhikuhiku	slowly
Rokerimi	Rockerim
Kanga	Curse
pouto	vertical
Kiroho	Kiroho
Kironi	Kilon
whakarawatia	locked up
whakamatemate	kill
tea	tea
Eriama	Eliam
kaukau	bathroom
Ihitopo	Egypt
Peterehopo	Bethel
Mamae	Pain
Tukitukia	Hit
totoka	solid
whakakuware	stupid
hopukanga	arrest
whakapikaua	load
Hikitia	Lift
ripiripia	ripped
ponana	rash
hoake	up
are	sleep
Horoi	Wash
tihe	sneeze
owha	owl
poutumaro	noon
heoti	finally
Kiriharehete	Kirjath-hareseth
Ewiri	Evil
Wahia	Divide
whakawatea	free
Para	Trash
tuhit	write
Tikiwa	Tikiwa
Pohokata	Laughter
Hepetipa	Hepburn
hoi	yes
tohenga	argument
whakakopaia	folded
whakarongoa	silence
Nitiroko	Nitric oxide
rukerukenga	chaos
whakarahia	increase
Terahara	Terahara
Retepe	Step
Tirihaka	Tirihaka
Houhia	New
mimi	urine
Taratana	Tartan
Awa	River
Ho	Yes
Haramanehere	Shalmanech
tuaraki	back
Katahewhere	Whereabouts
Amitai	Amitai
Iokoteere	Yokoteel
oto	sad
murere	silent
atawahi	atawhi
Atu	Away
arohatia	be loved
whakahauoratia	revive
marietanga	peace
whakak	complete
potopoto	gather
Tuwhera	Open
kah	where?
Whakamatauria	Tested
onga	yes
rarunga	problem
Pararaiha	Paradise
pawerawera	fever
matewaitanga	thirst
matekaitanga	famine
whakataurekareka	slavery
korekore	helpless
pehanga	pressure
koroi	crocus
Whakahekea	Downgrade
mahua	leave
Hurura	Hurula
riwaiti	receipt
whakairoa	carving
Moria	Moriah
whakatataia	approached
Kereroto	Gravel
Mehiremoto	Mehiremoto
Ieruha	Jerusalem
Iekoria	Jehoram
Iehoarana	Jehoaran
Himeata	Himeata
Iehohapeata	Jehoshaphat
Koutou	You
whakarong	listen
kaitarai	waiter
whakatuturia	stop
Eparima	Ephraim
Tekaria	Tekaria
Iiono	Ion
Pahuatia	Looted
Temaraima	Temaraima
whakahokihoki	return
tautohetohenga	controversy
mokopuna	grandson
paruparu	dirty
Tino	Very
pahika	bicycle
whakaahuru	comfort
hangareka	funny
Hene	Hen
papatanga	landing
tatangia	cut
Petehemehi	Beth Shemesh
kutete	stomach
Ekeroni	Ekron
whakataurerekatia	resolution
tawhi	hug
kupukupu	words
Whakaraua	Prison
mohi	little
paorooro	echo
momohanga	species
rapa	rubber
Ierameeri	Jerameel
patiri	parrot
Karimi	Cream
paiherea	welded
puruhi	flea
Kohatu	Stone
tahake	alone
in	in
hopane	soup
whakarawakore	uncompromising
karohia	avoid
Ui	Question
tirotirohanga	investigation
ih	oh
tete	small
takakinotia	abused
oi	yes
turuturu	leak
eka	acre
Ikaporo	Icarus
Mikirono	Micron
Iharair	Israel
whakaaraara	wake up
Matari	Matari
komeme	comedy
Topimi	Tophim
whakapu	clean
matapopore	morning
whakapapaku	my family
Karaitiana	Christianity
whakawateatanga	liberation
whakapiringa	contact
motokia	car
minitatia	minister
Pitinia	Bithynia
Taramoro	Taramoro
kaipakuha	buyer
Kapuru	Kapuru
howa	cold
Mai	From
inihi	inch
onematua	mother-in-law
porowha	square
tohaina	distribute
tataitia	sorted
rapupuku	search
paparanga	layer
Kipiri	Kipri
whakatere	navigation
Tipiha	Tipha
ropaka	frog
apititia	added
Taretana	Tartan
Tapata	Close
Haarapimi	Haarlem
Aronirama	Adoniram
Tapuru	Taburu
Tapahia	Cut
Hirihi	Hirihi
kaiarataki	leader
rakai	room
tipare	umbrella
hioho	alarm
kauparea	cover
apu	apple
oka	ok
whakararurarutia	disturbed
hautopenga	festival
Hemere	Hemer
Kinata	China
turorotia	sick
hoho	sleep
araira	path
maikara	good
Whakamamakia	Ease
Kenupata	Genupata
hokamora	skunk
pikake	peacock
makimaki	monkey
nahi	wish
Tokotoru	Three
whakakoromaki	endure
whakahurai	cover
taiohinga	adolescence
tuwahanga	first
whakawahine	feminization
taunutia	forbidden
tumau	permanent
kaiwhakamakuku	humidifier
matekore	immortal
Kuware	Foolish
whakatutua	to be angry
herekoretanga	freedom
whatiwhatia	broken into pieces
Kirihipu	Christian
Hotene	Hot
kaiwhakaaro	thinker
tiakitanga	care
Imiri	Imri
Eheke	Horse
Hearia	Sheria
Pokeru	Poker
Pinea	Pinea
Tehoara	Tehoara
Pitono	Python
Ehepaara	Marriage
Hahaka	East
Marakama	Marakama
Ahihuru	Thursday
Haniere	Haniel
Peri	Peri
Huara	Shula
Amara	Amara
Topaha	Topah
Hereme	Herem
Homere	Homer
Marakiere	Malakiere
Ihua	Ishua
Tahana	Tahana
Erara	Elara
Perana	Brazil
Arami	Alma
Teriarere	Teriarere
Iri	Hang
Etepono	Ethiopia
Iahupu	Jasper
Hukoko	Hukoko
Taperata	Taberna
Iokomeama	Jokhemeh
Amati	Amati
Eteni	Ethen
Toaha	Toaha
Hakia	Haggai
Horawia	Horavia
Paaraheremona	Baalhermon
Ahi	Fire
Huri	Change
Torai	Torai
Arono	Aaron
Tohipia	Toshibia
Haaraimi	Shaaraim
Ateme	Breathe
Nemuere	Nemuel
Tarono	Taron
Merere	Merre
Ieharereere	Jehareleel
Ehetono	Eshton
Ekera	Ekera
Itireama	Ithiream
Apitara	Abitara
taupoko	head
Meronoti	Meronoti
Kemuere	Kemuel
Hererai	Heresy
Piratoni	Piratoni
Tapariere	Curtain
Utieri	Utiel
Amarami	Amarami
Tehieri	Tehiel
Tokoono	Six
Mahatioto	Mahatioto
Hotiri	Hotiri
Maroti	Maroti
Iohopekaha	Joseph
Romamatietere	Romamatietere
Kirarati	Kirat
Eriata	Eliat
Pukia	Fire
Peno	Peno
Taatia	Print
Iehereia	Jeheria
Maatia	Please.
Hetiri	Hestia
Iakimi	Jakim
Miiamini	Miiamini
Tehoiaripi	Tehoiaripi
Tekameama	Tekameama
Teria	Teria
Tetama	Son
kaihahau	hunter
takiono	six
whakawhai	to kill
Ra	Sun
Torati	Torah
Manaheti	Manhattan
Hewha	Four
Maramana	Moon
Haapa	Hapa
Katete	Cattle
Tekamia	Tekamia
Hihamai	Hihamai
Eperara	April
Apaima	Apai
Iara	Yard
Maata	Clear
Kenata	Canada
Oteme	Autumn
kaiwhakararu	troublemaker
Akara	Agar
Am	Am
Topaka	Topaz
reir	rain
whakanekeneke	move
Kenania	Kenya
Aramoto	Aramoto
Mikineia	Mycenae
Eriperehe	Eliphaz
Katere	Catherine
Pakaru	Broken
Paaraperatimi	Baal Perazim
Eriparete	Eliphalet
Noka	No.
Erihua	Elishua
Pereteuha	Persephone
tohun	teacher
torohe	stretch
T	T
panaia	fired
Eretapara	Elezitbar
Ihimaia	Ishmael
putiki	boots
Taahiere	Walk
Toha	Share
Hotama	Hotam
Iohapata	Jehoshaphat
Aharai	Aharai
Karepa	Caleb
Nahari	Nahar
Tereke	Speed
Ahiama	Ahiama
Haaraponi	Haraponi
Arapati	Arab
Ripai	Ripai
Irai	Elijah
Hakamoni	Hakamoni
Irama	Light
Makatiere	Mackay
Mipitara	Miphtala
Pinona	Pinon
Ietete	Jete
Aria	Theory
Metahapa	Metasapha
Matarere	Weather
Mahareka	Happy
Awiti	August
Perara	Pearl
Rinihapa	Linhaba
Takana	Takana
Taawana	Tawana
Kerana	Karen
Ehepana	Spain
Ereraaha	Ellaah
Apira	April
Ihipaka	Egypt
Merana	Melania
Timirana	Timirana
Kerema	Grem
Apimaera	Abimael
Tikera	Tick
Utara	North
Ieraha	Jerah
Hataramaweta	Sataramweta
Aramotata	Almodatha
Ahura	Ahura
Hamati	Hamathi
Temari	Temari
Pataruhimi	Patrushim
Napatuhimi	Naphtali
Rehapimi	Rehabim
Anamime	Anamime
Hapateka	Hapateka
Totanimi	Dothanim
Erihaha	Elisha
Ripata	Ripata
Ahekenata	Ashkenazi
Tiraha	Tiras
Marai	Farm
ururuatanga	wasteland
tuaiwi	spine
rawai	raw
kain	food
arau	next
Makateha	Mactan
Kemarimi	Kemarim
Hararaka	Haradak
aina	land
aroh	love
whakapuhoi	soften
Kihereu	Chain
Potaea	Potaea
takahoatia	partner
paruauru	western
Mekirono	Mackerel
Harararimono	Harararimono
maruru	cloud
tuakanatanga	brotherhood
karangirangi	bright
auiwi	foreigner
rauroha	rauroha
whakatetere	accelerate
anahere	forest
mauaharatia	hate
Hina	China
Nikopori	Nicopolis
Aretema	Artemis
whakatupatotanga	warning
whakahoutanga	renewal
pukumahi	busy
taikaumatua	elder brother
Paarahamono	Baal Hamono
whakakopakina	folded
Peterapimi	Bethlehem
nati	nut
whakamaturu	to cool down
mawhatu	pebble
wherowhero	red
waiwai	wealth
whakaparua	double
kopata	drop
karamu	gram
hapirone	saffron
papuni	dam
Amana	Amana
iringa	hanging
puaka	pig
ipo	lover
parauri	brown
Kumea	Pull
kaihikihiki	hairdresser
Epar	Ephraim
whakawhanaunga	relationship
whakarererere	change
whakaputainga	publication
kapunga	cover
Whakangahorotia	Relax.
hoami	bring
whakaingoatanga	nomination
mariretia	peace
whakataurekarekatanga	happiness
whakaateatia	be released
tawhitotanga	old age
tupapakutanga	death
tupapakutia	dead
manakonako	hope
tapuae	shoes
whakapahemotia	be released
tapaina	named
whakahehe	objection
Kuaratu	Quartz
Teretiu	Teretiu
Hohipate	Hosipate
Ruhiu	Ruhiu
Orimapa	Olympus
Nireu	Nine
Piroroku	Blueberry
Herami	Sheram
Pataropa	Pataropa
Perekona	Peregrine Falcon
Ahunikiritu	Ashinkrit
Perahi	Brass
Taraipoha	Traiphoha
Taraipine	Trippin
Nakihu	Nakihu
Heroriona	Herodion
Aritopuru	Aritopuru
Takuha	Take away
Urupane	Urban
Amapiria	Amapiria
Hunia	Hide
Anaroniku	Anaronic
Epainetu	Epaenetus
Pipi	Chicken
whakawarenga	trial
Iririkuma	Iririikuma
ahuarekatia	enjoy
haurangitanga	drunkenness
kakainga	food
whakarapopototia	summarize
whakaatea	release
Whakawhiwhia	Grant
kaihoatu	sender
tokomahatanga	majority
whakapakeketanga	hardening
hiamoe	sleepy
kohumuhumu	whisper
whakatutuatia	be arrested
atuatanga	divinity
karakiakoretanga	irreligion
whakahuahua	outline
Aporiona	Apollyon
Aparona	Abaddon
Taru	Weed
atomato	first
Nepetarima	Nephedra
Reinga	Hell
hoihoi	interesting
Putake	Root
Raiona	Lion
patukituki	knock
waikorohuhu	water lily
mahanahana	warmth
Pirarerepia	Philadelphia
ukuia	polished
Kaiwhakaatu	Witness
mamara	light
karihoparaha	caribou
ngahauru	fun
karihorita	caribou
hararonika	sarong
karakeroni	karakulon
Koka	Goose
paiata	good luck
AKO	LEARN
ANA	HER
MAU	EVERYONE
HUNGA	FALL
KEI	HERE
NO	NO
AKU	ME
ETAHI	SOME
Anatipa	Antipas
arauna	allowance
Hamurana	Smyrna
Paraiha	Price
irua	two
hapaingia	welcome
reke	butt
maper	maple
whakakinga	filling
AO	WORLD
HOKI	BACK
WHAKARIHARIHA	HATE
KAIRAU	CHILDREN
WAHINE	WOMAN
WHAEA	MOTHER
NUI	BIG
PAPURONA	BABYLON
Aramakerona	Armageddon
Kohukohua	Koukohua
karep	grapes
wairuatia	be inspired
wuuru	wool
Parerepia	Libya
hamurana	hamurana
Patamo	Patmos
Rewa	Rewa
Marama	Moon
moutere	island
Koropiko	Koropiko
Hapati	Sabbath
piranga	beautiful
aritatanga	aridity
kahakinga	kidnapping
onanahi	yesterday
Muturapena	Muturabena
ngore	sleep
whakanoaia	defiled
whakamarino	refresh
warewaretanga	oblivion
Reanoto	Reanoth
whakatapatahitia	compare
unene	unen
kitoku	my
Whakatitahatia	Divide
Paka	Park
whakaohorere	excitement
Hakarini	Hagarin
kakore	useless
Whakahuatia	Mention
kowhakiwhakia	be careful
tautotoro	support
Taumarumaru	Shade
totohetanga	dispute
Whakaohoohokia	Be excited.
whakaitea	show
Takiwhitutia	Seven times
whakatakinga	dismissal
whakangahorotia	relax
rapurapu	search
matakuria	scared
Kuteretere	Kutseretere
Hiki	Hike
Hemo	Hemo
hukihuki	draft
whakareretanga	divorce
Tutuki	Hit
Pupuhi	Gun
Whakaraneatia	Improve
hokihokinga	return
whakatokotoria	planted
kaiarai	driver
Tapiritia	Tapiritia
Tini	Very good
paparuatia	double-sided
himenetia	hymn
Era	Era
hoihotia	horse
Himenetia	Hymn
tupuke	big
pe	yes
Makuku	Wet
whakamomonatia	be careful
hohonutanga	depth
anaki	anak
tungou	head
ngaueuetanga	tremor
Ierutonu	Jerusalem
Nekina	Yes
Aramatopa	Armada
Aramanaharaima	Armanaharaim
Pakoko	Bark
hamamatia	shout out
Kawana	Governor
kupa	cup
kowhakia	pinch
Pamau	Palm
taumarumarut	shadow
kopikopikotanga	wandering
rehokime	red wine
ereme	erem
Ionata	Jonathan
Maeneene	Smooth
wehia	fear
Purea	Purify
whakahaputanga	pregnancy
hukerikeri	cold
Whakataua	Decide
Nehiroto	Nehiroto
Whakapai	Cleaning
Taiawhiotia	Circled
taupatupatu	conflict
whakatangitangi	play music
Aratakina	Guide
Homhanimi	Homhanimi
kaikohukohu	gossiper
whakahaweatanga	contempt
Mitara	Mitara
Heremoni	Hermon
taoruoru	cool
whakatupehupehutia	reprimand
Wahangu	Silence
hauhau	cool
inua	drink
hamamu	shout
Matara	Distance
Kihakiha	Kisakiha
Waitohutia	Sign up
tautorotoro	support
whakangarahu	destruction
Okioki	Relax
Whakaahuareka	Pleasure
kaiwhakakata	comedian
waikauwere	water
poauautia	confused
maroketanga	dryness
makukuranga	wetness
ngahengahe	slang
potatutatunga	sloppy
kurupopo	croup
Kapohia	Captured
hemene	hymn
karopoti	skeleton
Waipuke	Flood
Kororia	Glory
hokite	back
Kataina	Cut
Airete	Airet
whakatihaia	be careful
Kihia	Kiss
whakahorere	to relax
Whakamakia	Watch
maturuturutanga	drop
kuare	ignorant
whakawhaiwhakaaro	to think
mahakai	greedy
pekea	jump
whengunga	slang
whakatupehupehutanga	reprimand
metotoru	three
omaki	storm
kopakia	closed
kaiwhakapumau	insurer
tiori	sly
makameka	star
hauhunga	childhood
whakatitaritaria	scattered
kaiuwhi	collector
huripokitia	upside down
maruwehi	sloppy
Whakapikoa	Bend
Whakahauorangia	Refresh
Horahia	Spread
tutea	spy
whakairohia	carved
whakahirihiritia	be careful
Whakahoroa	Destroy
waiate	song
Whakairia	Upload
inahi	yesterday
itinga	minimum
nenewha	nervous
kaipaihere	binder
kaikoti	cutter
moehewa	fantasy
taweke	handle
TAU	YEAR
Takiwhitu	Seven
HINE	WOMAN
anao	follow me
whakahauoranga	revival
REHE	LEHE
KOPO	END
TARI	TARIFF
PE	PE
AINE	SUBSTANCE
Tautokona	Support
HAMEKE	HAMEKE
NUNU	NUN
MEME	MEMES
RAMERE	RAMERE
Ahea	When?
KAPA	CAP
IOTA	IOTA
Marie	Marie
TETE	TET
KETE	KET
TAINE	WOMAN
WHAU	OVER
Whakapumautia	Confirm
TARETE	TARGET
Whakatirohia	Check it out.
KIMERE	CHIMMER
PETA	PETA
AREPE119	AREPE119
ohoreretanga	surprise
wahangutanga	silence
hopua	catch
Pekepeke	Jump
whanaketanga	development
tuaikerekere	late
kinogia	bad luck
perenga	wedding
itene	this
peipeia	beggar
tuwatawata	two-way
kipia	fire
hurorirori	roll
tiu	stick
wetiweti	wetsuit
papare	flat
whitia	cross
kuputapu	password
tuoi	you
whakangahue	relax
lhianga	language
whakakoarotia	turn around
Whakamanamana	Pride
teretere	hurry up
tuauriuri	shadow
rapeti	rabbit
Puke	Mountain
kawanatia	be careful
rarungatia	trouble
whakamataratanga	extension
whakatupuehupehu	to stir up trouble
Whakangoikoretia	Weakened
porangirangi	crazy
Mataara	Watch
Tomokia	Enter
Whanoke	Whanoke
tnngata	people
whakangarongaro	destroy
ahuarekatanga	pleasure
waitohutanga	signature
rohenga	boundary
tototanga	bloodshed
nehera	ancient
kowhiri	choose
titiwhatanga	observation
ratarata	love
purema	adultery
kotuinga	folding
katae	laughter
Katae	Laughter
maturuturunga	drop
whakamua	forward
whatuwhatu	broken
hapanga	pregnancy
kowiria	twisted
manawanuitia	be patient
tikaro	exactly
pukuwaitia	be careful
ngate	snail
Ukara	Ugar
Iakehe	Jace
Akuru	Akuru
Whakapaua	Accumulate
aritarite	anger
penapena	savings
kaiwhakamarama	interpreter
whakapiki	increase
mateoha	hunger
auau	regular
rutaki	ugly
puka	form
kaikawekawe	carrier
waroa	long
whakaparuparutia	be confused
ngawarika	easy
uakore	no rain
kaingare	sly
kohukohutia	slander
Tahia	Write
kotuituitanga	folding
Tatatia	Count
ahareka	fun
Whakatupuria	Grow
kaiapo	greedy
pukukino	angry
mamaoa	steam
taunahatia	pledge
pakiki	curious
tangatariri	angry person
rora	rain
Whai	Follow
mataratanga	distance
whakatakariritia	provoke
ngotonga	sleep
kokorutanga	inlet
Whakawai	Watering
matareka	fun
Utaina	Load
whakatakataka	prepare
takea	origin
ngakinga	cultivation
Hipoki	Cover
kaiunga	friend
Pahure	Pashupatinath
Rongoa	Medicine
tahuritia	turn around
Horomia	Swallow
Keremeneta	Clementine
Hinatiki	Sinatiki
Uoria	Uoria
tawhai	rival
Koinga	Home
whaikupuria	important
Pirimona	Philemon
Teparara	Tebalara
kimihanga	search
kaiwhawhaki	farmer
kaitahae	thief
tawhiu	old
Turihararai	Turisarai
kikupa	scumbag
amoamo	burden
Ataua	Atua
Ihowai	Oh my God
uruki	push
kawhakamate	deadly
whakanga	rest
kaikohuhu	speaker
nohonoa	casual
whakawaho	discharge
Perahere	Perahere
Heromi	Herod
Atana	Athens
Paranaka	Paranaque
Hipitana	Spanish
Epora	Ephora
Iokiri	Yokiri
Kihirono	Kihirono
Erirara	Elirada
Hemuere	Samuel
kaituwha	waiter
rotarotatia	rhyme
Tipirono	Cyprus
Hataraarara	Hello
Kareheparenga	Animal crossing
Aperehitimi	Aferhittim
Peteietimoto	Beth-jesimoth
Mitika	Myth
Mitikia	Mitika
Peteharana	Beth Haran
Iokopeta	Jokopate
Hopana	Hop
Ateroto	Ateroto
Peono	Peon
Nimira	Nimira
Turiere	Turiel
Raere	Monday
Whakatataia	Close up
tuathi	north
Korati	Coratia
Kohara	Gold
Hiremi	Hilem
Ieteri	Jether
Iahateeri	Jahazeel
Marakieri	Malachi
Marakierei	Malachi
Perii	Berry
Imini	Imin
Naami	Naomi
Arari	Arari
Huwhami	Huwhammi
Huwhama	Huwhama
Hupami	Shuppami
Hupama	Hupama
Ahirami	Ahiram
Ahirama	Ahiram
Ahaperi	Ashapuri
Perai	Yes
Erani	Elani
Erana	Erdan
Tahani	Tahani
Pekeri	Baker
Huteri	Huteri
Hewheri	Hewheri
Hemiri	Semir
Hekemi	Shechem
Aharieri	Ahriel
Hereki	Heresy
Ieeteri	Jether
Ieetere	Jether
Iahareeri	Jahreel
Iahareere	Jahareel
Eroni	Elon
Hereti	Heresy
Himironi	Shimron
Iahupi	Yasup
Ihaupu	Ishaupu
Hamuri	Hamuri
Pareti	Parade
Herani	Greece
Aroro	Aroro
Teponi	Japan
Tepono	True
Hauri	Hauri
Nemueri	Nemuel
mananatanga	success
tnei	this
Neumuere	November
Parui	Parui
Hanoki	Hanoi
Kohipi	October
Whakataria	Wait
Kohopi	Coffee
weohia	woven
tapenakar	tabernacle
paraama	light
Hepeta	Scepter
Whetu	Star
paraka	block
hamore	hammer
Hutoto	Water
whakahamumutia	be quiet
Petoto	Petoto
Hihoma	Shihom
Pupuke	Puppies
Atarimi	Atharim
manunu	bird
tauhuihui	gathering
kaiamene	manager
amauamu	complaint
Koreroki	Talk
ringihang	water
nihu	tooth
amuamutia	complain
rot	rot
Keuere	Geuere
Wopohi	Wrap
Nahapi	Nahapi
Mikaere	Michael
Heturu	Seturu
Kemari	Kemari
Kariere	Career
Rapu	Search
kohinga	collection
ianga	fish
what	what
haunui	big
karika	garlic
aniana	onion
merengi	watermelon
kukama	cucumber
kaanga	fried
takiamuamu	funny
hungawahi	foreigner
tawhiunga	collection
whakaatauranga	reflection
pokohi	bag
kaiaru	judge
Kenani	Canaan
Eparaim	Ephraim
aparana	apron
Hah	Haha
Hatiri	Hatiri
Perira	Perilla
Patariti	Patriti
Nepihehimi	Nephishehim
Pehia	Press
Hia	How much?
Horewa	Horeva
Henue	Hello
Nehumu	Nehum
Mihiperete	Miphreet
Nahamani	Nahamani
Raamia	Lamia
Eruru	Eruru
Kahamu	Kashamu
whakaponongatia	believe in
tarewatanga	debt
haukanga	marriage
kaiwaha	speaker
Mipikara	Mibikala
Tarapa	Tarapa
Parara	Parada
Pawai	Pawai
Atapuku	Atapuku
Harunu	Aaron
Harumapa	Harumapa
Harahaia	Harrahia
Meratia	Melatia
Pehoreia	Dismiss
Hahenaa	Hashenaa
omai	come
tuak	drink
inoitia	pray
atapu	holy
Maai	Good
Kirarai	Kirarai
Mirarai	Mirarai
paranga	pollution
Petekirikara	Bethel
Karai	Glass
Piritai	Bridge
Moaria	Moaria
Herekai	Herekai
Meriku	Meriku
Meraia	Meraiah
hemaia	shy
Maaria	Mary
Kinetoto	Kinetoto
Neparata	Nepal
Aiia	Hello
Enerimono	Enerimon
Mekona	Mekonas
Peteparete	Beth-pere
Tekapateere	Captain
Kihipa	Egypt
Itopara	Itopara
Huhupu	Huhupu
Haketorimi	Hagetorim
Ahatai	Ahatai
Peraria	Brazil
Mereioto	Meriyoto
Kapai	Kapai
Toere	Remains
Hataia	Hatred
Ataia	Ataia
whakataekau	tithe
oneo	sand
Hahapana	Hahaha
Hopeke	Hope
Pireha	Beer
Makapiaha	Maccabees
Nepai	Nephi
Peninu	Peninsula
Atania	Athens
Pirikai	Brick
Kihireu	Kihireu
whakamahunga	pregnancy
Utuhia	Paid
rurerurea	shake
Noamono	Noamono
tarapekepeke	jump
Mano	Thousands
Huhapa	Hushapa
taututetute	clash
Ngana	Try
atia	close
raw	raw
haeretanga	progress
Erekohi	Elekohi
weti	wet
kauhui	group
kouaua	you are welcome
Nimiroro	Nimroro
akuareiia	akuareia
Whakamamae	Torture
kup	cup
komotia	enter
kaiwahi	cutter
kakeke	hard
Moremorea	Moremore
Morehetekata	Moreheketaka
Whakamaua	Wear
Maroto	Dry
Peteetere	Bethesda
Taanana	Tanana
Hapiri	Happily
paripari	butterfly
waki	wax
Whakaatea	Free
Kerekehini	Kitchen
tarawahi	cross
kowhanga	hole
Iaua	Yes
maero	mile
komititia	committee
Wairangi	Water
rangatirata	grandpa
kama	bed
ehinu	five
koina	that's it
Nonahea	When?
Nohea	Where is it?
tautiaki	guard
matoke	cold
Parakia	Barakia
koiwi	bone
waeroa	mosquito
anihi	anise
whakahirangia	be careful
whakahira	attention
pairakere	slang
whakawhanuitia	expand
Pouriuri	Darkness
Whakaaetia	Accepted
Arakerauha	Archelaus
akangaromia	admiral
mawhera	open
wahea	when
kaiwhakamamae	torturer
pungaia	power
whakawerewerea	make fun of
Parahona	Parahon
Makarana	Macallan
whakakowaowao	choke
hangaru	wave
Wairau	Wairau
whakapaoa	to be happy
whakaokioki	relax
totea	salty
kanohiruatia	double-faced
waewaeruatia	two-legged
ringaruatia	second-hand
okooko	flower
turakanga	support
Taramanuta	Taramanuta
Epata	Ephah
whakapumanawa	inspiration
Hairopinihia	Syrophoenician
Koropana	Koropana
mahutatanga	freedom
Komorah	Gomorrah
Hotoma	Sodom
merek	market
kumi	kumu
Tarita	Taritha
mongomonga	small
kararini	clarinet
maramatanga	light
porewarewa	lightning
Poaneki	Boanerges
tutetutea	ttt
Irumia	Irumia
hairini	hairy
whakatutehutia	be confused
pakipakia	clap
riterite	equal
pauta	powder
patena	button
whakataiepatia	to be humbled
ukupa	frog
Timiuha	Timiusa
paratimiuha	parathimus
okookona	cocoon
nohohi	sleep
kaite	teacher
kaiwhakapareho	equalizer
kaioati	oath
rekaina	enjoy
whakahemokia	condemned
kaiwhakapai	benefactor
whakahohatia	intensify
kaitapae	opponent
kaiwhakaoho	alarm clock
whakatupererutia	be scolded
Maraki	Malachi
taumaru	shadow
iraia	radiation
mawehetanga	separation
whakahautia	ordered
Kuha	Door
uwhautia	beggar
kaikauhoa	friend
poutaru	pillar
kauhoatia	befriend
Naina	Nain
rongongo	listen
anui	follow
hangang	structure
whakaiia	complete
iaua	you
pukengatia	be careful
hakawhetai	thank you
aorangia	healthy
tairite	equal
honohonoa	connected
komukumuku	rub
taera	color
kakea	climb
haonga	catch
whakatotohu	recommendation
whakapakaru	to wear
Marereere	Happy
Haruku	Haruku
Menana	Menana
Merea	Merea
Honana	Jonah
Horimi	Horimi
Hohe	Active
Eremorama	Elemorama
Kohama	Kohama
Ari	Ari
Neri	Neri
Reha	Reha
Hemei	Semei
Nakai	Nakai
Eheri	Ashes
Matatiaha	Mattathias
Iana	Ian
Heri	Harry
apura	apocalypse
Apirini	Abilene
Raihania	License
Tarakonaiti	Dragonite
Ituria	Ituria
whakamakoha	relaxation
tunutunu	roast
Emauha	Emmaus
TENEI	THIS
kaimata	eye
panui	read
koparea	broken
tepe	limit
kakawa	thread
tataritia	wait
kahaka	scold
whakatatutia	set aside
Panuera	Banner
whakaharinga	joy
Kuirinia	Queen
whakaheanga	criticism
takiwhatia	broken
Takirua	Pair
Takitakina	Hit
whakarangia	be imprisoned
hikamaina	sikamaina
whakatarewatia	suspended
tawha	big
whakamatao	cool down
apoapo	late afternoon
mihia	thank you
tuaritia	share
amu	eat
kaikore	poor
ngongengonge	soft
kui	grandmother
houange	new year
wairakau	fertilizer
hiruharama	shirusaram
takarekare	restless
tirengi	green
rawene	raven
Rahi	Size
putunga	deposit
kaiwehewehe	divider
whakamoho	sleep
puhera	cellar
tahitahi	clean
tuwhatuwhaia	scattered
patukia	killed
hamari	hammer
heriko	Jericho
koiri	curl
whakakaupapa	outline
Kohuatia	Boil
whakakahau	confirm
whakaherehara	atonement
patenga	hit
mukumuku	silent
whakate	stop
kikini	kick
aminenga	agreement
whatakuhu	scold
ot	oh
karihariha	disgusting
whakangohe	soften
tuheatanga	waste
tuipiri	close
kaiutu	payer
naunga	property
Tipiri	Small
wairau	alcohol
mainga	arrival
akara	sign
komurumurua	whisper
parehe	flat
whakatiwhaia	be careful
tapapaku	dead body
whakaporotakatia	roll up
tototia	bloody
huruhur	chaos
tauta	city
whakaruaki	vomiting
whakatetetete	protest
tahgana	tahgana
whakatoka	planting
pokipoki	octopus
katapaea	offer
whakapokekoretia	uncontaminated
whakamotuhaketanga	independence
whakamotuhake	independence
waruhanga	eight
wariuhia	value
korom	chrome
otokore	free
kaipure	sailor
tukemata	eyebrow
reperatia	leprosy
tapouri	blind
tiwha	four
kowahi	smoke
pokeore	clean
horapatanga	spread
pokenga	pollution
kamiriona	mole
moeone	dreamland
korokotaera	crocodile
koka	crocodile
tuatara	tuatara
wihara	church
koeke	shrimp
pakauroharoha	pink heart
titorehang	heresy
hahae	tear
haumarurutanga	safety
Maharahara	Concern
Whakangaua	Hunting
hikihiki	move
hikihikitia	lift
Poutoa	Full moon
taupokinga	coverage
hurikiko	change
kurupatu	crush
tahangatanga	nudity
wherutanga	explosion
Periti	Perth
Aruma	Aruma
Meonenimi	Meonenim
Repanon	Lebanon
Iokopeha	Jacob
Tererara	Traffic
Petehita	Bethesda
kaimataara	watchman
koaro	inverted
takahuri	twist
manawhitiwhiti	grasshopper
miti	dream
Haroro	Haro
Ihowaharomo	Jehovahharomo
ahera	asher
whatorona	stretch
tuahangata	first person
Meroho	Fruit
pekenga	jump
Takatakahi	Takataki
rapurapunga	search
utuhanga	payment
Mamao	Remote
hihikotanga	enthusiasm
takitakinga	introduction
ton	tons
enge	yes
toropuku	thorn
Apioama	Apioama
Taanaimi	Time
Apionoama	Abionoam
Rapiroto	Rabbit
Heirata	Heirat
oapa	clap
M	M
Repona	Repona
tungia	penetrate
Kiromo	Kilo
auahi	smoke
Marehekepa	March
Paaratamara	Paaratamara
manukawhaki	birdwatching
ngaohi	beautiful
pineamine	Benjamin
kih	kiss
Timinataherehe	Timinathherehe
konene	container
tonene	tons
Mahanerana	Mahaneran
pupahi	butterfly
kiriwa	hair
kahoki	return
Iharai	Israel
Rakona	Dragon
angatira	boss
iotia	iotia
moh	oh
Horeke	Horrendous
ihi	fire
turuawaenga	middle ground
Kahi	Where?
Enehakore	Energy-saving
Ramatarehi	Ramatharshi
Timini	Timmins
Hirere	Hire
Aitarona	Aitaron
Iporete	Iboreta
Hiporete	Hiphop
Maoni	Maon
Kamono	Kamon
Aheri	Asher
Apiki	Apiki
Herepa	Hereafter
Aharapa	Aharaba
Naharoro	Naharoro
Kanaa	Kanaa
mon	for me
puruhekahekatia	blue sky
mahanatia	warm
puruhekaheka	blueberry
whakatoroa	prolong
Whakatotoro	Stretch
Ihariara	Israel
Heparimi	Sheparim
whakatanga	open
awhiotanga	storm
rung	ring
hohua	army
tapeke	total
auria	carry
motuhanga	divorce
hiti	side
Haretana	Sardan
kaing	food
Timenata	Time
Tipora	Zipporah
Penehaha	Penelope
hakaora	health
tapenak	tapas
tatakikotahi	one-on-one
Mewhaata	Mewhaata
Rimina	Rima
Karata	Carat
Karatana	Karatan
Hamotororo	Hamotororo
Mihara	Mishra
Tapare	Topare
Iharara	Israel
Peehetera	Beehive
Eretekeha	Erechtheion
Kipitaima	Kibtaim
Iuta	Utah
Tepiri	Tepri
Peineamine	Benjamin
mataki	watch
Iapo	Japan
Meiarakono	Mayor
Peneperaka	Penelope
Iehuru	Jehu
Eretekehe	Elekteche
Ietera	Jether
Haarapini	Harbin
Irihemehe	Irish
Horeme	Horemhe
Mikitaraere	Michael
Irono	Iron
Enehatoro	Enhatoro
Aramaha	Alamaha
Rakata	Rakata
Tirimi	Cream
Hur	Hur
Atanoto	Atento
Rakumu	Lakum
Nekepe	Nekebe
Taananimi	Tanananim
Umaha	Farm
Neiere	Nurse
Peteemeke	Bethemek
Ripinata	Lipinat
Miheara	Michael
Aramereke	Aramek
Petene	Bethany
Hahatima	Hashtag
Petepatere	Bethel
Eneharaha	Enharaha
Remete	Remete
Apete	Friday
Rapiti	Rabbit
Anaharata	Anaharath
Haparaima	Habraim
Kehuroto	Kehuroto
Katata	Close
Hanatono	Request
Neaha	What?
Itakatini	Itakatini
Kihiroto	Kihiroto
Rapahete	Rabashet
Marara	Scattered
Haruhene	Haruhene
Peterepaoto	Peter and Paul
Huha	Chest
Marakapoto	Short story
Peturu	Peter
Kipeata	Gibeah
Erepe	Eleph
Tarara	Dollar
Iripeere	Iripeel
Motaha	Motaha
Oponi	Opposite
Hamonai	Hamonai
Paraha	Bronze
Emekeketiti	Emekeketi
Keriroto	Keriroto
Enehemehe	Enshemehe
Hinimo	Hinnom
wahio	goodbye
Moh	Moh
Enetapua	Entebbe
Naarata	Naarat
Taanata	Talent
Iapareti	Japheth
aupiki	increase
Nipihana	Nipissing
Hekaka	Hekaka
Mirini	Mirini
Eretekono	Electronic
Peteanoto	Bethany
Maarata	Maratha
Kaini	Cain
Iokoreama	Jokhar
Iutaha	Utah
Tioro	See you later.
Humuta	Humus
Apeka	Aphek
Petetapua	Bethsaida
Ianumu	Janumu
Eheana	Eshana
Rumaha	Rumah
Animi	Anime
Ehetomo	Eshtomo
Kiriatahana	Movie theater
Ranaha	Rain
Netipi	Netipi
Ipita	Egypt
Kitirihi	Kitesurfing
Rahamama	Rahamama
Kapono	Faith
Rireana	Rilean
Mikirarakara	Mikalarakkara
Tenana	Tenan
Kererotaimi	Time
Kerera	Gerera
Aritaimi	Time
Haraimi	Haraimi
Enama	Enam
Torea	Torea
Hirihimi	Shirishi
Repaoto	Report
Hanahana	Hanahana
Kehiri	Kesiri
Eteme	Etem
Pitiotia	Ask
Peteperete	Bethel
Hehemono	Heshmon
Hatarakara	Hatarakara
Amama	Amama
Harata	Harat
Pearoto	Inside
Itinana	Italian
Kinaha	China
Iakuru	Yakuru
Hikirono	Hikeron
Keharono	Kesaron
ehe	this
Enehem	Enehem
Karakaa	Orange
Tawhono	Tawhono
Petearama	Beth-Aram
Petonimi	Betonim
Meono	Meon
Petepaara	Bethpaal
Pamotopaara	Advertising
Meara	Meara
Awim	Awim
Ahakeroni	Ashkelon
Kahati	Gath
Merono	Meron
Raharono	Laharon
Kerere	Greere
whakangonge	weak
Ihapini	Japonica
Repir	Depir
Horama	Horam
Maker	Maker
Hurihia	Change
Tahera	Tahera
Tapia	Repair
Pirama	Pyramid
pumahu	whisper
Tono	Request
hamaria	Samaria
whakatatau	close
whakawhetainga	thanksgiving
puhanga	explosion
Whakatakina	Introduction
whakapokarekarea	pollute
whakapokarekare	stir up
Petehera	Bethesda
Hamarai	Samaritan
Haika	Hike
Enona	Enon
Heparatia	Hebratia
toi	art
kuhi	mistake
Raponi	Rapunzel
kaihai	fisherman
arohia	pay attention
whakawainatia	be punished
uera	wire
NAHARETA	NAZARETH
Kapata	Captain
Whariki	Carpet
Auaka	Auka
makariri	cold
Maraku	Maraku
Kerono	Keron
notemea	because
mamate	death
whakaoraora	resuscitation
Whakapono	Faith
Roa	Long
tiriro	watch
Rawe	Raw
ngane	girl
whakaatua	show
hikirangi	skydiving
whakakotahitia	combined
Kaiwhaako	Teacher
kaiiriiri	baptist
Petapara	Petal
whakakikokikoa	full of life
Patupatua	Beaten
whakatoto	planting
Ru	Earthquake
tapeka	total
Tatua	Tattoo
putokitoki	smallpox
makau	favorite
kaiinu	drinker
rumakina	immersed
topa	zoom
mangaika	mangaka
whakapahemo	forgive
whakahaehaetia	discriminated against
Memeha	Memeha
kukuti	cut
Tirotirohia	Check it out.
weraweratanga	sweating
hukapapa	ice
ngoi	strong
whakakahukahu	wear
aionuku	ion
haukoti	interrupt
koreheke	empty
Kerenehapuku	Greenleaf
Ketia	Kezia
Hemaima	Shemaima
Tokowhitu	Seven
popopopo	pop pop
Pakari	Old
tawerewere	spider web
tuapa	father
koraahi	fire
kowha	hollow
rake	rake
powhiwhiwhi	midnight
tawhiria	click
Pehemoto	Behemoth
koreotanga	emptiness
whakatohutohu	recommendation
Horomititia	Swallowed
keokeo	white
hongia	smell
rarapa	lightning
nunumi	mix
Whakahawea	Mockery
hukari	ice cream
whewhengu	open mouth
whakamahanatia	warm up
raukura	graduate
rakarakatia	crowded
tuahiwi	spine
Whakahaweatia	Be mocked
Mataroto	Introductory
tio	ice
whakamakona	satisfy
rurukutia	shake
whakahautanga	order
houku	moisture
pakutanga	at the beginning
kuititanga	narrowness
whakamahatia	multiply
whakaminamina	flattery
Porahurahu	Porahurahu
awina	activity
whakawairangitia	be careful
marea	public
marou	thorn
Tupuhi	Storm
tutakitaki	meet
takiritanga	attraction
tamaroa	boy
taiohitanga	adolescence
tarenga	suspension
nehunehu	noisy
Whakapekaia	Be careful.
kono	knot
tatutanga	injury
whakaporearea	disturbing
atiatia	be careful
tatunga	preparation
hikitanga	postponement
whakaetietinga	comparison
marakerake	sloppy
whakakarangitanga	listing
Paruparu	Dust
Tuituia	Stitched
Humarie	Humarie
whakahewea	blame
Haehaea	Tear
kita	guitar
taupe	taupe
whakatoatoa	complete
kimokimo	blink
whaikorero	speech
whakahonoretanga	honor
Hiri	Seal
ngananga	scolding
waihotia	leave it alone
hamo	fish
tumautanga	stability
Karapitia	Karapitiya
pakawha	four
kapokapohia	be captured
Whawha	Four
Whakakorea	Cancel
poko	small
herehera	prison
Hohonu	Deep
Keiwha	Keiwha
makoha	stretch
Whakawhiwhi	Grant
tetepe	stop
kikiwatanga	proximity
whakauware	silence
atama	atom
Hapeana	Hapeana
kan	blood
whakaihoa	return
karare	glass
whengu	yellow
Waruhia	Scrape
akiritanga	rejection
mataatitia	watch out
rongoatanga	treatment
Putere	Money
kaitiak	clean
paruaruru	rain
harama	haram
Hiru	Hiru
puea	flower
totohutanga	sinking
porohurahu	snoring
ngangara	noise
Ahakenaha	Ashkenaz
Mini	Mini
poutangata	postman
whakaohongia	wake up
Whakakoia	Confirm
Inamata	Suddenly
kiakopere	archery
Repekamai	Rebecca
Ngateri	Ngateri
Horoano	Horoano
parara	para
rarau	reed
whakatupura	to be angry
Karangarangatia	Call
ururutanga	desertion
poroporonga	farewell
Merataimi	Merathaim
Napukareha	Nebuchadnezzar
Hatepea	Limit
Whakatakoto	Set up
takarokaro	play
towahiwahi	fragmented
Tetere	Trumpet
uritanga	birth
Whakahuihui	Gathering
kaitawhiu	prosecutor
omaoma	gym
whakakakaraki	trust
Herihiia	Sherichia
Ekerata	Egret
whakakakake	pride
Petemeono	Beth Meon
Petekamuru	Petkamuru
Peteripirataima	Bethlehem
Tangihia	Cry
whakanohopukutia	be careful
Maramene	Moon
Mihikapa	Mihikapa
rorohu	hair
kawehi	coffee
kaiwha	four
tukoki	cut
tautokorua	mutual support
horomi	swallow
powera	power
whakakanapatia	to shine
peai	maybe
mat	mat
hahanitanga	entertainment
naro	heart
Tetania	Tetania
Kerutu	Kerutu
Neputaarana	Neptune
Iho	Body
Paarihi	Paris
Hetania	Hetania
Epai	Yes
Tanahumete	Tanahumete
Hiruhar	Hiruhar
karenga	please
whakahotuhotu	to warn
totopu	body
Ngakia	Cultivate
Nepuhahapana	Nebuchadnezzar
whakawhakia	be divided
Harehekimi	Harechim
tawaitia	ridicule
or	or
kahua	station
Iukara	Yukara
Keraira	Kerala
kaitunu	cook
taotu	wounded
Iehukara	Jehukar
tapirit	close
Apareere	April
Eranatana	Elanathan
wharangi	page
Par	Par
Ikiraria	Igira
Hapatinia	Hapatini
aita	father
ohungia	scold
ararehe	animal
eatia	be careful
ahia	fire
itari	wait
whakapatar	contact
Koata	Glass
maung	mountain
whakatinaia	be quiet
kon	what
whakapaipaia	decorated
paoho	broadcast
anawa	ana
Nohoia	Occupied
at	and
Marenatia	Marriage
Herema	Herem
Aikaporo	Aquila
tato	tattoo
whakatikatikaia	adjusted
whakatututia	set up
arepe	morning
Ahakarono	Ashkaron
powaiwai	painting
kepara	chef
harakor	criminal
Merekia	Melechiah
tapui	closed
Whakahengia	Hang up
aea	yes
urona	uron
Pap	Pap
Mihapipi	Mishapipi
Makoro	Macro
kuhuna	enter
Kaiponuhia	Stop it.
Tou	You
man	man
aerea	air
tapitapi	worry
Parekura	Battle
tioro	watch
Hahiti	Hashish
whakapouarutia	confused
marangi	morning
anaunu	storm
hiia	fish
tur	tour
whakamoremore	relax
paremoremo	palm tree
whakakaoa	make fun of
kang	you
powhiriwhiritia	fan
taihaere	travel
kaiwhakatuwhera	opener
Whakaititia	Reduce
Whakakororiatia	Praise be to God.
ruharama	light
Hi	Hello
eoi	yes
tetah	one
Horona	Jordan
ngoa	good
mohoanga	home
rito	rite
Upata	Rain
Whakataka	Drop
okanga	surgery
waikuratia	rust
Whakapapaku	Dead body
hoariritanga	hostility
whakarata	calm down
tahatahi	alone
parairetia	bridle
Rongomau	Peace
Mutungakore	Infinite
Kaiwhakatakoto	Advisor
okeokea	sloppy
Takaia	Wrap
rohanga	room
Teperekia	Teberia
karaone	crown
Tapeara	Tapera
ngotungotu	snoring
Hearatahupu	Heartache
Huriharama	Jerusalem
peuhu	dirty
Meni	Men
arahanga	path
kaiwhakanoho	settler
kahuri	turnip
kaiwhakahua	speaker
Peura	Peura
whakapaipa	praise
kopare	mask
whareherehere	prison
hereh	hard
To	Your
pewa	bow
Whakaoranga	Rescue
kaonga	house
Nepaiota	Nebaioth
Whakapangia	Be careful.
kopengia	closed
ahurareka	fun
kaiwhakahou	innovator
kokirihanga	acceleration
whakatangorotia	be removed
hopuku	hurry
moto	motorcycle
whakamauiui	painkiller
huareka	pleasure
airua	air
whetero	scold
awenata	avenata
hona	here
hurarahi	reveal
kaihuna	secret
karapanaka	cash register
whakatiketiketia	exalt
Maunu	Bait
Ruperupea	Shake
Piko	Bow
tautiti	tie
Kohore	No
apena	like that
whakangihaia	ignite
whakamarotia	be careful
kaihutihuti	puller
oana	yes
ngaengere	scold
mao	white
Hinimi	Shinim
pakakinakina	sports
Whakaatu	Show
whaowhaoa	ingot
painatanga	pain
whakamahanatanga	warming
tonuitanga	continuity
Amohia	Take it.
kahor	before
Tapeani	Japan
Uia	Ask
kaihohou	traveler
tapokopoko	deep
meing	maybe
koropikoria	worship
whakamahana	heating
kaiperi	driver
kapehu	compass
kinai	kinai
kahekahe	scold
whakahotu	to settle
whakamorokitanga	humiliation
Here	Here
whakapaowa	to be angry
kope	diaper
whakaaroarohia	consider
kahikina	be careful
Rererere	Travel
kaiwhakamaeneene	softener
wit	wit
maroro	talk
porohita	circle
hangia	hang
whakapapakutia	contact
Whakamarietia	Be calm.
murara	green
tahutahu	magic
mamaru	shade
Heretere	Celery
Keria	Greece
whakapatia	to be happy
kaiwhakamine	collector
pao	hatch
oteriti	ostrich
hoehoea	shoe
punia	closed
Pawera	Fear
ruirui	shake
tarapeke	jump
kikiki	hurry
araaraia	wake up
whakangiha	ignition
apuhau	apocalypse
tautanga	familiar
whakarerere	change
whakarererea	repeat
koropuku	boil
Hanehe	Hanes
taparua	double
tatua	tattoo
hooro	long
hongihongi	smell
pakawe	wings
whakameamea	make a wish
karu	eye
uatoko	support
tautahito	ancient
hutohu	hint
hemorere	hemorrhoids
kohimu	secret
Kipeno	Gibeno
nakitanga	search
whakawhiri	click
kototi	cut
kurukuru	croak
taioma	time
tumatkauru	tumatakwaru
korohape	curve
rarurarutanga	trouble
Atawhaitia	Take care.
kauhoe	swimming
kaikauhoe	swimmer
whakamarumarua	protected
Ngakongako	Ngakogako
whakakarauna	crown
Whakawhiti	Transfer
whakarihia	repeat
Reranimi	Redanim
Kahekahe	Kahekahe
Harakono	Harakono
rurerure	restless
rure	shake
whakakuaretia	be ignorant
kaihora	provider
whakakainga	home
poropitianga	prophecy
Kiriharehe	Kirihareshe
iere	ask
roimate	death
toha	distribute
kaiwhakate	speaker
Peererimi	Bethlehem
Ekeraima	Ekraim
Herihia	Move
Ekarata	Ekrath
auetia	sigh
Paiti	Small
puruma	broom
purumatia	blueberry
Tawera	Heat
kaiaraarai	driver
tupekepeketanga	jump
tawhiritia	click
horehore	empty
hunuhunu	whisper
Kepimi	Kepimi
Maramena	Maramena
Aiata	Ayat
pipi	chick
Karano	Color
ngutukau	mouth
whakakotiti	shorten
piripono	loyalty
mamatanga	lightness
kukamo	cucumber
raupatutanga	conquest
ruhi	sleep
kaiahere	planner
Memepihi	Memphis
whaiaipo	dream
hanumi	merge
whakapetia	destroyed
kohiti	glass
hounga	new
horahora	spread
whakatotoi	art
whakangutungutu	stubbornness
uremu	weight
perai	like that
Paari	Wisdom
Ruhama	Ruhama
manawawhenua	homeland
tumere	chimney
whakamahangia	expand
konohinohitanga	confusion
Petearapere	Bethel
Haramana	Harman
Manukanuka	Fear
hemoreke	hemorrhoids
Roami	Roam
Ripiraima	Ripharim
akarerea	leave
Takawaenga	Mediation
whakakikoria	animated
whakatawhitotia	be quiet
kaiwhakamau	holder
whaeakore	motherless
matuakore	fatherless
harema	harem
whakaaringa	performance
Mutunga	End
whakakinoa	abuse
taungatia	be careful
Kotiti	Wrong
Tohunga	Expert
Tuturu	Real
Ngaueue	Shake
pango	black
whakatamarikitia	adopt
kaiwhakaoti	finisher
Potopoto	Short
whakaeketia	attacked
tonotono	macro
koheka	girl
pokaitia	surgery
Kahor	No
puhipuhia	shot
Pikitia	Picture
kaupuranga	assembly
Werohia	Challenge
Haereerea	Travel
Kuhana	Kushan
rerere	fly
Hikionoto	Hikoneto
hatepenga	hat
kaingau	dear
tuapuatia	strengthen
kokoa	chocolate
wheoro	virus
whakatuara	wake up
tinanatia	physical
whakamanutia	to be broken
kopera	copper
kawhena	coffin
haenga	rent
moatia	first
pike	pike
potonga	cut
Mupimi	Mupimi
Ehi	Smoke
Peraha	Peraha
Hipiona	Siphon
Puwa	Flower
whakatakirua	double
kit	kit
Whaowhina	Help
takirimatia	five times
muringa	rear
pam	pump
aohanga	economy
Tawhanatapaneaha	Tawhanatapaneaha
whakaheia	condemned
mihio	know
taramore	taramore
toremitanga	drowning
kiroki	fat
hohepa	Joseph
Iupara	Jupara
Iapara	Jabar
Metuhaere	Travel
Metuhare	Methuhar
Noro	Noro
Ketipi	Ketchibi
ero	strange
Arawa	Arawa
Mehetapere	Mehetapere
Hemerana	Hemran
Eihona	Eishon
Aiaha	Aiaha
Hepo	Hepburn
Arawana	Arawan
Hemama	Hemama
Neparoto	Nebaroth
Penoni	Benoni
Aronipakuta	Aronbakuta
Erepeteere	Elizabeth
Ereerohe	Black
Hareme	Harem
toitoti	limp
Peniere	Peniel
tukuna	released
Iekarahaharuta	Icarus
Kohia	Collect
mahine	month
koroa	crown
Rapanga	Problem
tihorenga	peeling
whakatakiwatia	separate
anau	curve
waimarie	luck
nonoketanga	confusion
hauhautanga	coolness
rapaki	rap
Whakatutukitia	Execute
kamea	kame
tapanga	label
rauako	teacher
Iuriti	Iuritius
Hepaha	Sheba
Ahutata	August
Hitina	Hitina
whakatetete	shake
Arapeere	Arabic
Reumime	Reumime
Retuhimi	Retuchim
Ahurimi	Ahurimi
tuahiahi	evening
raahi	step
wahina	virgin
Tahaha	Tahaha
Kahama	Kahama
Reuma	Rheumatism
Irirapa	Irida
Piretata	Police
Hato	Saint
Kehere	Prison
Kemuera	Kemuel
Hutu	Shoes
Ihowatire	Oh my God
tamarihi	child
Tangata	Human
Wahine	Woman
whakatutakina	be introduced
Pihona	Pihon
whakahangia	aired
Penami	Benami
whakawareware	forget
huringa	change
raweketia	mixed
Penatia	Penatia
matamat	watch
Perere	Pearl
koeni	koen
Karamoni	Caramel
porohanga	slice
mahuetanga	absence
Hopaha	Jobah
Koimi	Search
Hatetonatamara	Hatetonatamara
Enimihipata	Enmishpat
Ereparana	Elparan
Tutimi	Tutimi
Karanaima	Caranaim
Ahateroto	Ashtoreth
Hemepera	Hempel
Hinapa	Mustard
Pireta	Pilatus
Korimi	Corinth
whakamihi	admiration
Iheka	Iheka
whakapoauau	confuse
Opara	Opara
Arahapata	Arapaho
Ketera	Ketura
Raha	Money
Aarawari	Aarawari
Kaheruhimi	Kaheruhimi
Rehena	Rehena
Ereke	Erek
tuaiti	small
Whenua	Country
Rangi	Heaven
Awatea	Daylight
whakatoria	be careful
Pikaua	Pikaua
pareho	both
whaiwhai	hunting
hoariritia	enemy
kaiwhakawhiwhi	recipient
tauiw	tawny
whakatauiwi	paganism
whakawhenumitia	mixed
ani	please
Matapoporetia	Stressed
Paunatia	Pound
Hakatana	Hakata
iko	I
Erihoenai	Elihoenai
riuha	rose
Akameta	Akame ga Kill
Ahanapere	Ahanapere
Erami	Elam
Rehawi	Rehawi
Huhanaki	Susan
Arakewi	Archaeologist
Aparahi	Aparaji
Taraperi	Strawberry
Aparahataki	Aparataki
Rinai	Rinai
Tapeere	Theater
Pihirama	Bismuth
whakararurarua	double trouble
hairuha	hair
whakamomemiti	flattery
iwaiti	few
Tairani	Thailand
haotu	share
meura	mule
Hatira	Hatira
Perura	Peru
Patarutu	Patarutu
Nepuhimi	Nephilim
Pehai	No way
Hiaha	Hijab
Horawai	Horawai
Hairiri	Hairy
Makapihi	Macabre
Kiriataarimi	Kiriatharim
Kipara	Gibara
Ioraha	Jorah
Mitipara	Meatballs
Reeraia	Reelaia
Iarau	Ira
Tepina	Tepina
Hahai	Follow
Makanarepai	Good morning
Taahau	Sorry
Wania	Wania
Keru	Search
Pereia	Berea
Uere	Wire
Maarai	Garden
Teremai	Welcome
Heara	Shear
Atarai	Atari
Atita	Atita
Tetia	Tetia
Ramia	Ramia
Keraia	Keraia
Poto	Short
maram	month
Tahatia	Together
Katoa	All
rutu	struggle
whakariroinga	change
Whakapokea	Pollution
Tamutu	Tamutu
keringa	call
ariha	leader
whakarih	change
arikitanga	sovereignty
Ripirata	Liberata
rak	rak
whakapakok	to complain
ahoretia	never
titari	wait
kaiheu	barber
Meripata	Meribah
whakawhititia	transferred
aenganui	middle
Meripoto	Meripot
Hatikono	Haticon
Hipiraima	Hibraim
Perota	Perot
waimaori	fresh water
Eneekeraima	Eneekreaim
muimui	follow
kauhoea	swim
whakaheretotokore	sacrifice
koro	old man
mane	morning
ngak	ok
Whanganga	Measurement
huiti	narrow
aparua	apocalypse
roanga	length
hatapihi	hampis
paparua	double layer
marima	five
ete	summer
ketek	ketek
mirete	millet
Hamona	Salmon
kaitanu	cook
kutia	cut
hani	honey
gungu	crow
whakan	open
mohoia	be quiet
nengaro	mind
pahu	drum
tute	tax
gia	old man
whakaoran	rescue
roreka	happy
tat	tat
komuhumuhua	whisper
tahari	wait
wherikoriko	snoring
whakatorona	throne
Tehapanehe	Tehran
Pipehete	Pipette
kaiwhakatupato	warning
Terapipi	Terapipi
kuihitanga	goosebumps
pahore	no one
urutuatia	adapt
rerehua	butterfly
kohukihuki	hurry up
whakawahangutia	buried
Moremore	Moremore
tak	ok
harihari	happy
Kirimara	Kirimara
Kane	Male
Herepono	Prison
panaka	bank
eponi	ebony
Kamarimi	Carnation
taumanu	bench
kataka	kata
Keretimi	Gretchen
memehia	be careful
whakaii	pride
Purangatia	Purangati
koropuputanga	boiling
nakohakoha	strange
Hoa	Friend
rurutia	shake
waitohungai	signature
waitohungia	signed
anana	pineapple
whakakoromeketanga	confusion
tairangatanga	elevation
Pama	Palm
nohio	small
ngihia	burn
maniania	noisy
whakamareke	relaxation
whakamakukutia	watered
whakawaina	judge
torotoro	exploration
Katohia	All
iara	yard
whakamanawatanga	encouragement
akatikaia	approved
kekeno	seal
toitutanga	integrity
wairu	wine
tuke	elbow
paparu	shallow
whakapoto	abbreviate
kaipani	reader
taturanga	tattoo
koto	hole
Pokaia	Pokaia
korori	glory
torotika	straight
hikonga	electricity
whakapuehu	dust
Aohia	Aohia
matikara	finger
apoapohia	be happy
whakamuia	back
ngahuehue	hustle and bustle
Putiera	Putiel
Apihapa	Abishab
Erihepa	Elizabeth
Hitiri	Hitiri
manenetanga	immigration
whakaokuokutia	be released
Whakaotia	Complete
whakatatutatu	hurry up
taungia	land
whakaarahi	raise
rinema	linen
rihena	rice
taimona	demon
mangemange	thirsty
pekaha	strong
Hae	Jealous
hakatupuranga	generation
tukuroa	prolong
Taraia	Wait
manakoh	wish
kapuna	captain
aurutia	aurora
tuihituhi	handwriting
ihipa	Egypt
purupuru	blue
Whakiia	Open
honginga	smell
karapanuma	carabanuma
oneka	other
takete	background
karamuha	karamuha
ANO	AGAIN
mumu	red
whakawhaiwhiri	choose
whakakohao	open
tuhinga	document
rinea	linen
whakawhaiawhi	to be involved
ririte	equal
whakapahika	annoying
kohirahira	beautiful
totomoka	blood clot
hangaitanga	structure
tura	honor
atiti	attitudinal
totohenga	dispute
kaiwhakatuputupu	creator
kaireperepe	speaker
whakamangeretanga	extension
kaumatuatia	grow up
hurahanga	revelation
Taiepatia	Good morning .
whakawahanga	trial
matatu	three
Ihowanihi	Ohana
moere	sleep
Whakaaturanga	Presentation
potakataka	round
amua	tomorrow
rutia	root
matapouri	dark
Whakamarokia	Dry
whakamareretia	be scattered
hakaritia	celebrate
matatia	open
hipera	hyper
Raamahehe	Raamahehe
Pitoma	Pithom
whakawhui	hurt
Waietata	Waietata
Arirai	Arirai
Arihai	Arihai
Paramahata	Paramahata
Arirata	Arirata
Araria	Arada
Porata	Porat
Ahapata	Ahapatha
Rarapono	Faith
Parahanarata	Parahanarata
Hiwana	Siwana
ronatia	rontia
hing	hang
tetau	year
Whakahohorotia	Hurry up.
itenga	head
kawanata	space
whaina	fine
Tepete	Tebet
Haahakata	Funny
kini	now
Marahena	Marahena
Merehe	Meresh
Aramata	Armada
Karahena	Karasena
Karakaha	Karakaha
Tetara	Tetra
Apakata	Funny
Pikita	Picture
Pitita	Pizza
Mehumana	Mehuman
tokotoranga	bed
akau	right
korukoru	turkey
ngaungau	chew
kahakahakina	engraved
Atuakore	Godless
Kotinga	Cut
Kotingakore	Uncut
maoritanga	nature
kaiwhakaki	filler
tuhono	connect
hape	wrong
kaipaowe	speaker
tiketi	ticket
takitoru	triple
whakatokorua	double-digit
kotui	zipper
hip	hip
waira	fertilizer
kae	yes
amenea	amenea
kaitangi	singer
kaihuri	changer
ahuareke	aura
houkuratanga	graduation
puhuki	blunt
tami	jam
kaiwhakananu	mixer
whakahangai	to guide
matakaitaki	step by step
takatakanga	preparation
ngota	atom
whakangakungakutia	confess
patokia	knock
ataritari	wait
whakap	contact
arewa	north
whakataritari	provoke
Ihip	Egypt
marenarena	wedding
mareitia	married
titahatanga	slope
Pehere	Prison
ngar	good
whakapatarita	provoke
kaiotatanga	membership
ataruatia	affected
papatairitetanga	equality
kaiwhakawhanui	expander
kanapanapa	bright
roharoha	generous
taiwhiotia	surrounded
kopatapata	sloppy
pataritari	provoke
Hako	Shark
whakaroanga	extension
whakamaiatia	be strengthened
Ahatotopihika	Achatopsika
Rapata	Rabat
huarangatia	root
kaiutuutu	drawer
kaitata	printer
whakawhiwhinga	award
TOU	YOU
kurunga	institution
uauatanga	difficulty
waihakihaki	water
makamakaia	beautiful
hopurupuru	blue
warewar	war
ukui	wax
ketu	this
nea	now
whakapokenga	infection
kaheru	hawk
whakaahiahi	evening
Petoro	Peter
romiromia	romomia
unakatia	close
whakakinokino	abuse
haututu	rebel
mena	if
kauaemua	don't worry
maria	Mary
Keremota	Gremory
Kapatora	Captivity
Hamahumi	Tenth
Whakahau	Command
en	en
pukapua	flower
riwhiria	choose
Whakatekautia	Tithe
kireti	kilt
weherua	split
temera	fever
pikareka	funny
tiwhaina	clean
Pakarua	Broken
waengan	middle
tanumai	burial
Mohera	Mohera
Iakana	John
Peerota	Beirut
Haua	Disability
rir	laugh
arenea	development
Karehep	Karehep
Whakarangona	Listen
Kareheparena	Karesaperena
Rihahapa	Rizaphap
Topera	Topel
mutun	end
awaker	wake up
akawahia	be careful
tet	yes
whakatutukitanga	achievement
tiia	tea
kipi	rebellion
takatakah	takatakah
whaitohu	certificate
PEREHE	PRESS
UPARAHINI	UPARAHINI
parah	bad
ohio	ohio
akaititia	decrease
whakakit	show
tik	tick
Inu	Drink
gatiratanga	ownership
kaw	close
mak	ok
poutoutoa	all-round
epukaneha	ephesus
N	N
Rura	Rura
whakauruuru	join in
tupua	idol
whakapotonga	abbreviation
whakamaharo	amazing
kaiwhakakaha	amplifier
gitanga	guitar
Upuhata	Upuhata
matauran	knowledge
Etahi	Others
Ahapenata	Ashpenaz
Naimapa	Map
Hierapori	Hierapolis
Raua	They
ngakautia	heart
tauhere	prison
Haitiana	Haitian
atawhaikore	unkind
pokano	mushroom
tuhonohono	connection
Upoko	Head
Pauhua	Price
Korohe	Empty
Taia	Print
kowhititianga	crossword clue
kaikikini	cheerleader
Kiunu	Kiunu
Hikutu	Hikutu
Kinongia	Love
mia	my
matariki	star
kaitinei	waiter
goa	goa
tarokore	breadless
Haramona	Salmon
Panuitia	Read
Kirioto	Kirioto
pipiripia	torn
whakangakau	heart
whakapapanga	contact
whakapororarutia	confused
Torotika	Straight
tuwheratanga	openness
Ahota	Ahota
haraiata	horse
Kanarahi	Ghana
tuhaha	spit
Reipana	Lebanon
Moroko	Morocco
whakamohiotia	be informed
Riperetini	Libertine
Nikora	Nicholas
Paramena	Parliament
Timona	Simon
Nikanora	Nicanor
Porokoru	Frog
Teura	Teura
Kamariera	Gamaliel
Piriniha	Prince
Rokohina	Rokohina
erehere	prison
Hapaira	Sapphire
whakaaranga	resurrection
ihaka	fish
meati	meat
pona	laptop
pita	pita
Wharetoru	Three Houses
Apiu	Apiu
Makete	Market
Puteori	Money
Rekiuma	Rheumatism
Hairakuha	Hyrakuha
Poruku	Porcupine
Katoro	Castor
koripi	sloppy
werewere	sly
Merita	Malta
papakirua	double-sided
Hatihi	Hatchimals
tangere	long time
Karaura	Cloud
Urokarairona	Urocharyon
rekareka	fun
kapene	captain
Rahia	Russia
Kokoru	Bay
Haramone	Salmon
Hiniru	Hinuru
Raikia	Raikia
Maira	Miles
Ataramituma	Ataramituma
whakaw	to judge
Porohia	Proclaim
Ruruhira	Ruruhira
tuhitu	write
Nahareti	Nazareth
whakatikatikaina	adjustment
Anatipatari	Antichrist
whakatakoko	to start
wahirua	half
rukeruke	messy
maetia	clean
taututetutenga	confrontation
temepa	temple
Tokowha	Four
whakangakaukore	heartless
Toromai	Toroma
Pinika	Pink
Patara	Patara
Koha	Gift
Papaku	Shallow
Torokiriuma	Trochleum
Hamo	Ham
Kio	Fish
Mitirini	Mitrin
Utiku	Utiku
roatia	long
Piru	Blue
Hopate	Hobate
hio	see
rongonui	famous
Ripia	Libya
pamapuria	pump
Perukia	Peru
Kaparokia	Kaparokia
Patia	Hit
whakarapopoto	summarize
kokiritanga	rush
Rimitiriua	Rimitiriua
Hewa	Wrong
aikiha	aikiha
Tairanu	Mix
kura	school
Pirihia	Close
roaroa	long
Ramari	Ramadan
Rionaihia	Dionisio
Taihoa	Taihoa
Poka	Bag
Toika	Toika
Epikureana	Epicurean
Atena	Athens
whakatutungia	be aroused
whakaohotia	wake up
Aporonia	Apollonia
Amapipori	Amphibious
kanui	gun
tohutohutia	recommended
koroni	colony
Neapori	Naples
Hamotarakia	Samothrace
kariki	Greek
Piniki	Pink
Whakau	Trust
Merekurai	Hermes
Erima	Elim
Paraihu	Brush
Harami	Harami
Herukia	Cherubim
Motuhia	Cut off
Manaena	Manaena
Rukia	Russia
Nikera	Nigeria
whang	scold
Parahitu	Paradise
pepehi	baby
Rora	Road
patototanga	knock
parekereke	heel
mutumutu	intermittent
whakamaunga	preparation
menenga	sink
Koronira	Corona
et	and
whakarehu	perfume
Pahapa	Error
ururatia	shake
Akerama	Akram
tupou	head
tamene	dam
Rioterepi	Dioterapeuta
Rinuha	Linus
Purena	Purena
Upuru	Upuru
kirihipi	crystal
Karapu	Club
Raramatia	Ramatiya
Kerekena	Crekena
omakia	hurry up
Hamapiri	Close
Hani	Hani
heahea	silly
ririhau	angry
Oma	Run
Piritu	Bridge
Himeniu	Hymen
kikohangatia	be careful
kaikai	restaurant
kaiwhakatu	founder
whakahoia	mobilize
Heremokeni	Hermogenes
Paikeru	Biker
matengakore	immortal
tima	team
whakakahanga	lighting
Unihi	Uni
Roihi	Lois
rim	rim
oura	our
Perotai	Perotai
Petaha	Bethesda
Hareretere	Hareletere
Metekeama	Metkeama
ine	measure
inakuanei	recently
hokoi	buy
awiri	two
tukitukinga	collision
Nakono	Nacono
Paare	Bar
Iapai	Japai
Rakapa	Ragapa
mahanatanga	warmth
taika	tiger
ringi	ring
Hiraha	Shirah
anere	aner
Ap	Yes
heo	fish
Ritipa	Retirement
Kireapa	Gilead
iriwa	eight
anahe	alone
Ranaiaana	Latin
Tahatimihorohi	Tahatimhorohii
Ititi	Itchi
Paarai	Barai
Heterai	Hesserai
Ahahapai	Aha
Iahene	Yes, sir.
Parahumi	Parahumi
Apiarapono	Apiarapan
Hirai	Hirai
Mepunai	Mepunai
Anetoti	Anetotis
Erika	Erica
Ariare	Ariare
Tehoiara	Tehoiara
Ake	Next
Arino	Arino
Takamoni	Money
Iohepepahapete	Joseph and the others
maonga	surprise
kaihimene	singer
mohungahunga	toddler
Huakina	Attack
whenunga	explosion
roritia	funny
Iaareorekimi	Yaareorkim
Hapa	Error
Ihipipenopo	Egypt
whakatarea	to be prepared
Mehorati	Mehorati
Aramoni	Almond
Haorohe	Hello
hutoto	wet
Hairi	Hairy
Arorama	Vision
Hep	Hep
eti	right
Pitirono	Peter
Kipe	Kip
Haturimi	Haturim
Ahuri	Ahuri
upu	word
einga	yes
perepoti	airplane
tauhiku	drop
neti	net
arik	arik
Apohara	Absalom
Hopi	Soap
Itira	Itzira
tetai	one
akauanei	this is true
kanganga	suffocation
Epaina	Epaina
Petemerehaka	Beth-mereshak
Amonono	Ammon
whakapouaru	widow
parai	fry
Amoanono	Amoanon
attahua	beautiful
harou	snoring
Teriria	Terri
manuhuri	bird
pahi	bus
onu	one
titro	tit
Ierupehete	Jerubbesheth
tako	lie
Hopaka	Hopaka
Kopaka	Kopaka
kotah	kotah
Iahera	Jasher
taupato	caution
kaiwhakamanumanu	hunter
tauarua	double
rorea	scold
ruku	dive
makenu	death
Matau	Right
totoa	brave
wheau	shell
Kaikaranga	Reader
hamiti	hamlet
parati	plate
whakapaipaitia	decorated
Ipereama	Abraham
Kuru	Kuru
Pirikara	Birkara
whui	fight
ehoi	hello
Tairi	Tire
auraki	mainstream
raano	wide
oe	you
ikohuru	murder
tapunga	closure
kapa	team
honea	honey
Hirianai	Syrian
topetope	short
aroar	aroar
Whakaae	Agree
whirinaki	trust
atau	or
rukuhanga	diving
rukuruku	sink
Apana	District
Paarahariha	Baal Harish
katokatohia	complete
tihetanga	density
kopikotanga	curvature
tamai	father
aaturia	show
kaikotikoti	harvester
kaipiu	passenger
atenga	head
katohi	map
nahumete	Nahumete
Pupurona	Burmese
maturia	clear
Nehuhuta	Nehuhuta
Tepura	Table
takohatia	donated
Kitiro	Kitiro
Natanamereke	Nathanael
kapuka	coffee
Harahaha	Hahahaha
ringiringihia	pour
Ierira	Jerilah
Iotopa	Iosif
Harutu	Harut
Mehuremete	Mehuremete
parameti	parameter
Peroraka	Perolaka
Hetekai	Hezekiah
Pakira	Bald
rereruatia	double
kone	cone
raroa	below
Kake	Up
makaia	thrown
ainei	now
Rapaharihi	Rapahari
aranata	orange
whakapikau	pack
Honea	Honey
Nehuhatana	Nehushtan
Api	Api
Hakop	Jacob
Anamereke	Anamelek
Heparawaimi	Hephaestus
Tarataka	Tarataka
Nipihata	Nipita
Awi	Good morning
Ahima	Ahimaaz
Kutu	Lice
Penoto	Bento
Hukoto	Sukoto
Kuta	Kuta
Whakorekore	Unrequited
Ianoa	Janoa
Arie	Arie
Ripiripia	Liberia
Apek	Apek
Koperea	Shoot
Pupuri	Hold
Penehaara	Ben-Hadar
Iotaka	Iotaka
tohung	teacher
Iehohepa	Joseph
whakamotitanga	destruction
whakangarom	destroy
koutu	goat
enga	yes
pepa	paper
kaiwhakapohehe	deceiver
ponotia	honestly
hihiri	motivation
whakamanamanatia	boast
whakarawakoretia	be relieved
aituha	accident
haku	boss
Manako	Desire
iokatia	yoga
rungia	feel
hereheretanga	imprisonment
hohia	hug
ahuarekaina	enjoy
rangitahi	temporary
hipoko	hippo
rungatia	above
muhumuhu	whisper
Kahakina	Kidnapped
Areta	Areta
pahiatia	be beaten
kaiwhakawahi	firefighter
kaiwhakau	founder
Pewhea	How?
nuku	move
K	K
uwaha	mouth
Hamatatopa	Hamatatopa
whakawhuia	be tortured
Tereata	Television
Nepukaneka	Nebuchadnezzar
Whakaahua	Photo
tauhuihia	add up
pokoh	body
Haharaha	Hahahaha
Tokohata	October
kiha	kiss
maaheia	easy
Hohai	Gift
maitai	good
whakakotititia	be careful
apuakina	help
Hinomi	Hinomi
Ihimakia	Ithaca
matamaua	first
Puaki	Puaka
tuhituh	write
hakamoemiti	praise
araima	lime
Ep	Ep.
Hatahi	Together
Ihara	Crime
ungutu	snort
Whakakikoruatia	Coated
Parawaima	Parawaim
ohunga	slang
Ioah	Joah
whiuwhiua	whip
whakangoikore	weaken
Kimito	Kimito
Hararai	Harari
natanga	birth
rakaia	locked
Kurupaara	Kurupaala
Iapane	Japan
Repano	Lebanon
hakaaro	think
pahuati	spoil
Timiriti	Timiriti
mahiku	sly
hoiara	water
Ie	Yes
Erihapata	Elizabeth
Rorawa	Heavy
whakapo	complete
Whakatikatika	Correction
Ieruere	Jeruel
Hatetono	Hatton
taritari	wait
whakatauria	decided
Hiruha	Jerusalem
koai	who
Aheroto	Azeroth
Imi	Search
pakuwha	small
Amahia	Amaia
Topoaronia	Topoaronia
Penehaira	Benelux
Aperemaima	Abremaim
paraket	blanket
Tepata	Tepata
Eperaina	Ephraim
Tehana	Tehanna
ahoroa	morning
Hukiimi	Shukiimi
Tahama	Tahama
Aroaraima	Arodarim
Etema	Etham
Harorama	Harorama
tekaia	lie
Ponotio	Pontius
Whawhaitia	Fight
hawata	dangerous
Haimeniu	Hymenius
kuwaretia	stupid
tapukore	unholy
Kapea	Okay.
Whakamatautauria	Test it.
rahirahi	big
whakahihiri	inspiring
Hariha	Harihar
Apiaha	Abijah
Pekorata	Pecorate
Teroro	Teroro
Pinemine	Benjamin
Hoere	Hall
Petekara	Bethel
whatiri	thunder
reria	ready
tahangatia	naked
tuahu	altar
whakaputaputa	publish
utumu	utumi
tum	tum
whakahuatanga	pronunciation
parekua	scold
Ataka	Attack
Korahana	Korahana
Rakara	Rock
Hipimoto	Hippopotamus
rio	river
hirihiria	whisper
Kireti	Crete
Maoko	Maoko
wahin	wood
kot	but
ronga	hear
Ahimerereke	Ahimelech
hakoa	good luck
Pinemini	Benjamin
Harete	Haredi
kimikumi	kimchi
huhare	sigh
whakapotatutatu	hurry up
hahaketanga	sunrise
poroaki	goodbye
Apenere	Abner
whakakaumatua	aging
whakapaunga	expense
takotaoranga	survival
Aianei	Now
Heku	I
Naiota	Naiota
Tawiri	Twist
whakahipa	to hide
ito	it
Mehora	Major
rihitini	receipt
Pi	Bee
whakatene	please
kerono	geron
hati	heart
ruruatia	shake
taora	throw
Epeheramime	Ephraim
uwha	female
aurara	aura
whakaparahakotia	insult
Ke	Yes
Teraimi	Teraim
Tomotomo	Tomotomo
Raru	Problem
Pepeke	Bug
tatauria	count
Tatauria	Count
Henehe	Old age
Potete	Pot
kaikakahu	dresser
whaiuru	participate
rawhi	clamp
Pehek	Pesek
pewhea	how
Tereta	Telera
Iorohama	Jeroham
Ramataima	Ramatime
horomanga	absorption
Amin	Amen
Whakamanuhiritia	Welcome
whakakakahuranga	clothing
Pihopa	Bishop
whakatupapaku	massacre
hetia	wrong
Hiahia	Desire
Kaporokia	Cape Verde
whakatakohatia	contribute
Etanimi	Ethanim
pamekarenete	pomegranate
whakatura	stop
wahiawhi	hug
arapaki	arapaki
whakawhitiwhiti	communication
Mahoro	Hurry
Rarara	Darara
kakera	snoring
Parua	Barua
Aroto	Inside
Ahinarapa	Ahinarapa
Penekepere	Pengebere
taupae	bench
Arupoto	Short story
Penehehere	Ben-Hesher
Petehanana	Beth Hanan
Makaha	Makaha
Penerekara	Penelope
Penehuru	Penhuru
Ahihara	Ahihara
Erihorepe	Elihoreph
tamia	clean
toanga	success
whakangohengohe	soften
Whakarihariha	Disgusting
wenata	wenata
whakahok	return
Himeiki	Himeiki
Ioap	Joab
Ir	Ir
whakakoara	brighten
Tuatorutia	Third
tuhurihuri	twist and turn
kaiwhakararuraru	troublemaker
mawehenga	separation
wharorotanga	expansion
Keriti	Crete
Keriri	Kerry
Hiere	Hier
Etepaara	Ethbaal
Arata	Arata
Ihono	Connect
Hetiono	Hesiono
Taparimono	Taparimono
whakapataritaritia	provoke
hotanga	success
whakaho	activate
teira	that
poama	bomb
Reho	Return
Aroama	Aroama
Terua	Third
Terera	Telera
Retona	Retona
amia	amia
raku	raccoon
horomona	hormonal
anai	termite
Aron	Aaron
Toherete	Toheret
Rei	Ray
atawhia	welcome
whakahoanga	friendship
whakahoatia	be friendly
whakahaereere	management
apotorotanga	apostolate
whakapupuhi	to blow up
rorona	long
haratau	convenience
akamanawareka	happy
hoakore	friendless
Kokoa	Kokoa
Maranata	Maranatha
Anatema	Anathema
Pirihiria	Priscilla
mihi	thank you
Akaiku	Akaiku
Porotunatu	Protonatu
kimo	blink
kahatia	force
ngoikoretia	weakened
kororiatia	honored
honorekoretia	dishonored
piraukoretia	incorruptible
pirautia	rotten
mehema	lady
tomuri	late
whakahirihiri	to shake
uhua	fruit
marutuna	scold
whatia	break
hipokikore	uncovered
makete	market
wawau	ridiculous
Koroi	Chloe
tuituia	stitched
Taharea	Waste
Marihihua	Marihuana
Himeana	Himeana
Pakapakakara	Spices
Mehiremiti	Mesiremi
Tahatera	Tahatera
Maahiai	Wise
Ipiniia	Egypt
Mikiri	Mikri
Ipineia	Epinayia
Hahenua	Hahenua
Tarea	Task
Takere	Takere
Tarehia	Wait
Heharia	Shehariah
Hamaherai	Shamasherai
Ipereia	Spain
Anatotia	Anatolia
Ihipana	Egypt
Himirata	Himalayas
Tiretai	Chiletai
Erienai	Elienai
Ieteria	Jezreel
Ihimerai	Ishmael
Heteki	Hezekiah
Arere	Ared
Mihama	Misham
Apitupu	Apitupu
Mirima	Mirima
Teutu	Pay
Horehe	Animal
Haharaima	Shaharaim
Hepupuana	Hepburn
Ahoa	Hello
Noha	Nowhere
Ahara	Ahara
turan	turn
Retia	Letia
Ura	Ural
Pihipa	Bishop
Peera	Beer
Hiriha	Shirish
Haranepere	Harenber
Tehupa	Tehupa
Rohoka	Rohoka
Ahawata	Ashawata
Pimihara	Bimhara
Pahaka	Pashaka
Piritawiti	Blacksmith
Naarana	Naarana
Nono	Nono
Rehepe	Rebekah
Repaha	Rephah
Uteneheraha	Utenaharaha
Aniama	Aniama
Rikihi	Rice
Ahiana	Asian
Ihihoro	Ishihoro
Hamorekete	Hamorekete
Rakeme	Rakeme
Perehe	Press
Ahere	Here
Ahihahara	Ahijah
Tetana	Tetany
Aramete	Alamet
Temira	Temira
Tipihama	Tiphama
Iahamai	Yahamai
Teriere	Terrier
Hepaata	Shebaatar
Aneme	Anime
Pireama	Balaam
Anere	Andrew
Hirene	Siren
noe	no
Kihihi	Kiss
Paaheia	Passed away
Perakia	Be careful.
Ahiari	Asiari
Towhai	Towhai
Ahimoto	Ahimoto
Teaterai	Theater
Har	Har
Tahariere	Tahariel
Norapa	North
mahio	know
Apariere	April
Taharo	Wonder
Tehihai	Tehihai
Taroa	Taro
Tia	Yes
Taanai	John
Atata	Nearby
Peeraha	Beer
hotau	today
Hipi	Sheep
Tehimiere	Tehimiere
Hehohaia	Jehoshaphat
Taakopa	Taakopa
Ahiere	Asher
Tamareke	Children
Mehopapa	Mehopapa
Tokene	Token
Petepirei	Bethel
Hatarahuhimi	Hatharuhimi
Petemarakapoto	Bethel
Torara	Torara
Hamuere	Samuel
Keteraha	Kedarah
Netaimi	Netaim
Tahupi	Tasupi
Harapa	Harap
Kotepa	Kotepa
Tokimi	Tokimi
Ahapea	Ahah
Raara	Ladakh
Reka	Taste
Penetohete	Pentecost
Tohete	Tohte
Tirono	Tyrone
Penehanana	Penhanan
Himono	Simon
Nahama	Naham
Pitia	Ask
Iekutiere	Jekutiel
Iehuria	Jehuriah
Tiria	Share
Tipaha	Tipha
Iru	Iru
Keharahimi	Geshari
Meonotai	Meonotai
Hatata	Hatat
Rekaha	Rekaha
Irinahaha	Irinahahaha
Tehina	Thursday
Peterapa	Peter
Mehiri	Thank you.
Aharahere	Aharahere
Topepa	Newspaper
Anupu	Anupu
Etenana	Ethan
Ietoara	Jethro
Haahahatari	Risk
Temeni	Temeni
Ahutama	August
Huhaha	Hahaha
Haterereponi	Hatterley
Iripaha	Iripaha
Ihima	Ishima
Rahara	Lahar
Ahumai	Industry
Anani	Anani
Horaia	Horaia
Paria	Paris
Hetere	Heather
Tuhapa	Tushab
Hataria	Hataria
Ohere	Oher
Nerapia	Nerabia
Iekamia	Jekamiah
Henatara	Senator
Marakirama	Marakirama
Patahua	Patahua
hingi	hang
turang	position
Iatiti	Yacht
Opiri	Ophir
Ararai	Road
Haroni	Sharon
Hitirai	Hittite
Kereri	Gary
Hipini	Sheep
Ramati	Ramat
Eteri	Ether
Aroni	Aaron
Itirahi	It is important.
Hamahutu	Shamahutu
Amitapara	Amitabha
Rorai	Road
Teriia	Search
Harekete	Charadet
Hemakia	Hemakia
Repaere	February
Peurutai	Peru
Iataniere	Jataniel
Korohi	Korohi
Teharera	Teharela
Teri	Terry
Atarera	Atarela
Ipiri	Add
Kamuru	Kamuru
Ehekiere	Ezekiel
Apahehe	Apahehe
Iehepeapa	Jezebel
Hupa	Soup
Hakoto	Hakoto
Heorimi	Seorim
Riwa	River
Tina	Mother
Hatiere	Hatiera
Iephui	Jephun
oatu	give
tarat	tarat
Rahami	Rahami
Iaare	Yard
Hipai	Hippie
rakaraka	fast
poroporoa	goodbye
tin	tin
Hemata	Hematite
Hukati	Stop
Himeati	Himeati
tirati	trust
Tori	Tori
Ehetauri	Esther
Mihirai	Mihriam
Humati	Humati
Haroe	Haroe
Petekarere	Bethel
Harepe	Harep
Makapena	Mackenzie
Tirihana	Share
Kehama	Kehama
Taharai	Taharai
Torokoama	Torokoama
Rahama	Rahama
Tata	Close
Moriri	Moriri
Ahapana	Ashapana
Ekere	Acre
Orene	Orange
Puna	Source
Ararono	Aralon
Tehere	Prison
Ierioto	Jericho
Kerupai	Cherub
Patehua	Butterfly
Aramamaaka	Aramaic
Hawaha	Low
Kunu	Kunu
Tipihata	Tipitapa
mono	plug
tuatahitia	first
mahama	light
Kenainia	Kenya
Iahia	Young man
Atiere	Atiel
Taatiere	Waiter
Kuhaia	Kuhaiya
Peeriara	Beeliar
Ereparete	Alfred
puri	hold
tapatupatu	collision
Hirono	Hirono
Paaraha	Baraha
Tiritai	Treaty
rangapu	group
Makapanai	Macapanai
tuatekau	tenth
tuarina	back
Mihimana	English
naterope	natrelope
rauhangatia	strategize
Toera	Soldier
Toetere	Train
Harupi	Harupi
Pearia	Bereavement
Erutai	Erutai
Kererati	Crete
Iohapara	Josaphat
Ietiere	Jezebel
Kipeati	Gibeath
Hemaa	Hemaa
Metopai	Methope
Itima	Itima
Erenaama	Elenaam
Tohawia	Tohavia
Teripai	Teripai
Mahawi	Mahawi
Aroeri	Aroeri
Ahaterati	Ashtoreth
Mitini	Mission
Arina	Arina
Peroti	Perot
Hakeri	Hacker
Mipihara	Miphihara
Etepai	Etpai
Naarai	Naarai
Hetero	Hetero
Mekerati	Mekrates
Eripara	Elipara
Hake	Hake
Kitoni	Kiton
Haheme	Hashem
Paharumi	Spend
Pirotoni	Proton
Hamoto	Hamoto
raroraro	underground
Paharamime	Parsley
Hepi	Hep
Ariana	Ariana
Homama	Light
Tepi	Tape
Atapeere	Antebellum
Heruku	Heruku
Arawari	Easy
Kaharuhimi	Kasharuhimi
