鼓舞人心的	encouraging
麻煩製造者	troublemaker
駭人聽聞的	appalling
餵養得很好	well-fed
頭腦簡單的	simpleminded
非常不幸地	miserably
電話·阿比	Tel-abib
難以置信的	Unbelievable
阿爾菲厄斯	Alphaeus
阿波羅尼亞	Apollonia
阿多尼卡姆	Adonikam
阿多尼勒姆	Adoniram
阿什脫雷思	Ashtoreth
閃閃發光的	sparkling
閃閃發光的	shimmering
閃閃發光的	gleaming
長子繼承權	birthright
邪惡的心腸	Evil-hearted
還有米所巴	Jamlech
達爾馬提亞	Dalmatia
迦特-臨門	Gath-rimmon
貝絲·拉法	Beth-rapha
說不出話來	speechless
被驅逐出境	deported
薩莫色雷斯	Samothrace
萊桑尼亞斯	Lysanias
花言巧語的	smooth-tongued
興高采烈地	gleefully
自掃門前雪	minding
臨時抱佛腳	crammed
臥床不起的	bedridden
綿羊剪羊毛	sheep-shearers
索斯特內斯	Sosthenes
約施比加沙	Joshbekashah
精心設置的	well-set
米格代爾迦	Migdal-gad
米施利米雅	Meshelemiah
第四十一屆	forty-first
第二十四屆	twenty-fourth
第二十六屆	twenty-sixth
第二十二屆	twenty-second
科尼利厄斯	Cornelius
盲目崇拜的	idolatrous
發育過度的	overgrown
狄奧尼修斯	Dionysius
特爾蒂烏斯	Tertius
無政府狀態	anarchy
死亡的打擊	deathblow
極好的裝備	tooled
森納赫里布	Sennacherib
普布利烏斯	Publius
放得太多的	heaping
拉瑪的拿約	Naioth
所羅門群島	Solomons
懷有惡意地	spitefully
思想開明的	open-minded
心理諮詢師	counselors
從人的角度	humanly
底格里斯河	Tigris
幼發拉底河	Euphrates
帖撒羅尼迦	Thessalonica
希拉波利斯	Hierapolis
布巴斯提斯	Bubastis
巴力赫爾蒙	Baal-hermon
巴力毗拉心	Baal-perazim
尼科迪默斯	Nicodemus
尼布甲尼撒	Nebuchadnezzar
安普亞特斯	Ampliatus
奔亞比拿達	Ben-abinadab
外國出生的	foreign-born
基列·巴力	Kiriath-baal
埃塞俄比亞	Ethiopian
埃塞俄比亞	Ethiopia
埃克巴塔拉	Ecbatana
土生土長的	native-born
哈達·臨門	Hadad-rimmon
和平締造者	peacemakers
厄貝雅塔爾	Abiathar
即將到來的	impending
卡帕多西亞	Cappadocia
千夫長押拿	Adnah
加布里埃爾	Gabriel
克里斯普斯	Crispus
傑霍薩達克	Jehozadak
偶像崇拜者	idolater
信心十足地	confidently
佔主導地位	dominated
伯阿爾貝爾	Beth-arbel
伯巴力米恩	Beth-baal-meon
伯亞斯瑪威	Beth-azmaveth
伊拉斯塔斯	Erastus
亞述巴尼拔	Ashurbanipal
亞蘭·瑪迦	Aram-maacah
亞多尼洗德	Adoni-zedek
亞多尼比色	Adoni-bezek
亞伯米何拉	Abel-meholah
亞伯伯瑪迦	Abel-beth-maacah
二十蒲式耳	twenty-bushel
也跳得厲害	quaked
不可改變的	unchangeable
不可戰勝的	invincible
上帝賜予的	God-given
點點滴滴	morsels
麻風病人	lepers
麻風病人	leper
麵包師傅	baker
麥基舒亞	Malkishua
麥基洗德	Melchizedek
鬼鬼祟祟	sneaking
鬥毆事件	brawls
鬥智斗勇	wits
高高興興	happily
高速公路	highway
骨瘦如柴	scrawny
驚慌失措	panicked
驚天動地	shattering
驅逐出境	deport
馬蒂亞斯	Matthias
馬爾基爾	Malkiel
馬爾休斯	Malchus
餓壞了的	ravenous
風暴重創	storm-battered
頭髮花白	gray-haired
頭腦清晰	clear-eyed
預料到的	predicted
預先安排	prearranged
革尼撒勒	Gennesaret
靠近摩利	Moreh
非精神的	unspiritual
非生產性	unproductive
非常討厭	loathing
非利士人	Philistines
震撼人心	humbling
電話·戒	Tel-harsha
雷霍博姆	Rehoboam
雨後春筍	springing
難以置信	incredible
雅撒尼亞	Jaazaniah
隨地吐痰	spitting
除此以外	otherwise
阿雷塔斯	Aretas
阿蒂米斯	Artemis
阿荷利巴	Oholibah
阿茲列爾	Azriel
阿納達布	Ahinadab
阿糖胞苷	Ara
阿比蓋爾	Abigail
阿比書亞	Abishua
阿格里帕	Agrippa
阿拉伯人	Arabs
阿拉伯人	Arabians
阿德里亞	Adria
阿尼色弗	Onesiphorus
阿姆拉姆	Amram
阿塞納絲	Asenath
阿佩萊斯	Apelles
阿佐圖斯	Azotus
阿什杜德	Ashdod
阿什凱隆	Ashkelon
防腐處理	embalmed
防禦工事	fortifications
閃閃發光	sparkled
閃閃發光	shone
長期冷清	long-deserted
鐵青的臉	ashen-faced
金光閃閃	glittering
野生動物	wildlife
重音符號	accented
重新開放	reopened
重新填充	repopulate
重新加入	rejoins
重新分配	reassign
重新出現	reappears
都市實踐	Urbanus
還有老年	well-aged
達瑪里斯	Damaris
遊樂設施	rides
遇船難者	shipwrecked
連衣裙的	dressed
連續下坡	slopes
連根拔起	uprooted
這樣宣稱	proclaims
這幫傢伙	woodsmen
逍遙法外	unpunished
迷迷糊糊	stumbled
迦基米施	Carchemish
迦勒底人	Chaldeans
迦勒以法	Caleb-ephrathah
近親結婚	intermarriage
輪廓分明	chiseled
軟體動物	mollusk
身體素質	fitness
身材勻稱	shapely
躡手躡腳	crept
起死回生	life-giving
走投無路	cornered
費斯圖斯	Festus
費利克斯	Felix
貴重物品	valuables
貴橄欖石	chrysolite
財務主管	treasurers
貝蒂埃爾	Bethuel
貝爾謝巴	Beersheba
貝塞斯達	Bethesda
豐衣足食	clothed
誹謗性的	scandalous
語重心長	earnestness
訓練有素	well-trained
討價還價	haggles
討價還價	bargains
討價還價	bargain
言不由衷	insincerely
言不由衷	insincere
觸目驚心	startling
觸目驚心	shocking
解除綁定	unbind
解除武裝	disarmed
觀察到的	observed
親密關係	intimacy
褻瀆神明	blasphemous
褻瀆的話	blasphemy
製陶工人	potter
被忽視的	neglected
表達感謝	thanking
行色匆匆	hurrying
血跡斑斑	bloodied
蜂擁而至	flocked
虛虛實實	falsehoods
薩比教徒	Sabeans
薩拉米斯	Salamis
蓬勃發展	flourished
蒙住眼睛	blindfolded
蒂邁歐篇	Timaeus
葡萄採摘	grape-picking
萊西阿斯	Lysias
舉步為艱	reeled
與此同時	meanwhile
與此同時	meantime
臭名昭著	notorious
臭名昭著	infamous
自由意志	freewill
自我毀滅	self-destructive
自我放縱	self-indulgence
自我控制	self-control
自我否定	self-denial
自愧不如	humbled
自告奮勇	volunteered
臨門帕烈	Rimmon-perez
腳踏實地	surefooted
腳踏實地	hardheaded
腓立比書	Philippians
脫口而出	blurted
能力傾向	aptitude
胡說之人	babbler
胎死腹中	stillborn
背信棄義	treachery
肅然起敬	awestruck
耶路撒冷	Jerusalem
耶路巴力	Jerubbaal
耶羅波安	Jeroboam
耶是比押	Jeshebeab
耶布斯人	Jebusites
耶布斯人	Jebusite
耶亞巴琳	Iye-abarim
老老實實	honestly
羊群效應	herding
羅螺紋鋼	Lo-debar
經常光顧	frequented
經久不衰	unfailing
索西帕特	Sosipater
紅潤的臉	ruddy-faced
精雕細琢	crafted
精心打造	well-built
精心培育	well-nurtured
精力充沛	lusty
米非波設	Mephibosheth
米沙德代	Ammishaddai
米推利尼	Mitylene
米實利末	Meshillemoth
米力巴力	Meribbaal
算命先生	fortune-teller
第五十二	fifty-second
第二十五	twenty-fifth
第二十三	twenty-third
第二十七	twenty-seventh
第三十六	thirty-sixth
第三十八	thirty-eighth
第三十五	thirty-fifth
第三十二	thirty-second
第三十九	thirty-ninth
第三十七	thirty-seventh
第三十一	thirty-first
立足之地	foothold
立在那裡	throngs
穿著涼鞋	sandaled
稱霸一方	lording
稅收徵收	tax-collection
稀里嘩啦	splinters
移情別戀	faithless
科林蒂安	Corinthians
示米拉末	Shemiramoth
示法提雅	Shephatiah
示利米雅	Shelemiah
破壞性的	devastating
瞥了一眼	glanced
看跌期權	puts
直截了當	straightforward
目瞪口呆	stunned
目中無人	defiant
盆滿缽滿	pours
皮西迪亞	Pisidia
皮膚光滑	smooth-skinned
的災害中	devastations
白色挑染	white-streaked
發育不良	stunted
發生衝突	clashed
發出噓聲	hissed
發人深省	provoking
癲癇發作	seizures
痛改前非	repentant
異端邪說	heresies
異國情調	exotic
男性親屬	kinsman
男子氣概	manhood
由來已久	long-standing
生育能力	fertility
生產廠家	manufacturer
生生不息	ever-flowing
瓢潑大雨	downpour
瑪拉基書	Malachi
瑪士利加	Masrekah
瑪土撒拉	Methuselah
瑪他提亞	Mattathias
理直氣壯	righteously
理所當然	granted
珠光寶氣	jeweled
猶太教堂	synagogues
狼吞虎咽	gorging
犯罪分子	offender
物物交換	barter
牢不可破	unbreakable
牛角撞傷	gored
爬行動物	reptiles
燈紅酒綠	feasting
煽動叛亂	sedition
無論如何	anyway
無罪釋放	acquitted
無痛人流	painless
無法無天	lawlessness
無法忍受	unbearably
無法忍受	intolerable
無法形容	unspeakable
無法形容	inexpressible
無法形容	indescribable
無所畏懼	fearlessly
無意義的	meaningless
無家可歸	homelessness
無家可歸	homeless
無可指責	blameless
無人盯防	unmarked
烏合之眾	rabble
為期三天	three-day
為情所困	lovesick
灰頭土臉	disgraced
潘菲利亞	Pamphylia
漫不經心	unconcern
漠不關心	unconcerned
漠不關心	indifference
滿目瘡痍	devastated
準備就緒	readiness
游牧民族	nomads
海風吹拂	windswept
流離失所	displaced
洛尼克斯	Andronicus
洗劫一空	ransacked
洗劫一空	looted
泰蘭努斯	Tyrannus
注意事項	precautions
注意事項	attentions
波浪狀的	wavy
法律顧問	counsel
法利賽人	Pharisee
沙本人以	Eliahba
沒頭沒腦	unthinking
沒有愛心	unloving
沒有受傷	unhurt
沒完沒了	never-ending
江湖醫生	quacks
求賢若渴	thirsting
永不褪色	unfading
氣吁吁的	panting
毫髮無損	unscathed
毫無疑問	doubtless
毗他希雅	Pethahiah
比較喜歡	prefer
比蒂亞亞	Bithiah
比提尼亞	Bithynia
比扎萊爾	Bezalel
比尼亞幹	Bene-jaakan
比利洗人	Perizzites
比亞利雅	Bealiah
每月一次	monthly
殘羹剩飯	leftovers
死記硬背	rote
死氣沉沉	lifeless
死亡纏繞	death-wound
歷史學家	historian
歡欣鼓舞	rejoiced
歐布洛斯	Eubulus
歐尼西慕	Onesimus
格拉森人	Gadarenes
朱利葉斯	Julius
本·奧尼	Ben-oni
未受割禮	uncircumcised
期待已久	awaited
服務承諾	pledges
有說服力	persuasively
有聲有色	impressive
有義務的	obliged
有經驗的	experienced
有組織的	organized
有吸引力	attractive
有名無實	figurehead
有同情心	sympathetic
最聰明的	smartest
最純淨的	purest
最明智的	wisest
最強大的	mightiest
最年輕的	youngest
最佳裝備	best-equipped
替代對象	Replaces
曾經荒涼	once-desolate
曷哈及甲	Hor-haggidgad
星光燦爛	starry
昏昏欲睡	drowsy
明目張膽	flagrant
明目張膽	brazenly
日益減少	dwindling
斑紋灰色	dappled-gray
敬畏上帝	God-fearing
敘利亞的	Syrian
攻破以雲	Ijon
收穫時間	harvesttime
撲朔迷離	confusing
撒都該人	Sadducees
撒縵以色	Shalmaneser
撒瑪利亞	Samaritans
撒瑪利亞	Samaritan
撒瑪利亞	Samaria
撒弗提迦	Sabteca
搖擺不定	wavering
搖搖欲墜	shaky
插科打諢	gag
提供服務	served
推雅推喇	Thyatira
振奮人心	exalting
指指點點	carted
持之以恆	persevere
拉美西斯	Rameses
拉扎勒斯	Lazarus
扶正祛邪	rousing
扣人心弦	exciting
托勒梅斯	Ptolemais
打個噴嚏	sneezed
手足情誼	brotherhood
手無寸鐵	defenseless
手工製造	handmade
所有消費	all-consuming
我們自己	ourselves
成群結隊	droves
戈蘭高地	Golan
懸而未決	unanswered
慶祝活動	festivities
慶祝活動	celebrations
慈善機構	charity
愛發牢騷	grumblers
想個辦法	outnumber
惡魔附身	demon-possessed
悲慟欲絕	grief-stricken
性急的人	hothead
思想生活	thought-life
快樂瘋狂	pleasure-crazy
忘恩負義	unthankful
忘恩負義	ungrateful
心地善良	good-hearted
德魯塞拉	Drusilla
德米特里	Demetrius
微不足道	insignificant
得出結論	conclude
強制實施	enforces
強制執行	enforced
弗里吉亞	Phrygia
弗里伯恩	freeborn
引人注目	striking
幾乎沒有	scarcely
幸災樂禍	gloated
幸災樂禍	gloat
平板電腦	tablets
帕特莫斯	Patmos
希羅天安	Herodion
希伯來語	Hebrew
希伯來書	Hebrews
布魯克斯	brooks
巴魯米人	Arbathite
巴比倫人	Babylonians
巴末巴力	Bamoth-baal
巴旦亞蘭	Paddan-aram
巴施戶珥	Pashhur
巴拉啤酒	Baalath-beer
巴塞洛繆	Bartholomew
巴力米恩	Baal-meon
巴力洗分	Baal-zephon
巴力毗珥	Baal-peor
巴力夏瑣	Baal-hazor
巴力哈蒙	Baal-hamon
巴力哈南	Baal-hanan
尼陀法人	Netophathites
尼陀法人	Netophah
尼希米記	Nehemiah
尼姆羅德	Nimrod
尼卡諾爾	Nicanor
尼亞波利	Neapolis
尚美學園	Shobi
尚未收割	unharvested
尖酸刻薄	vinegar
少走彎路	detours
少年時代	boyhood
尋歡作樂	merrymakers
將軍朔法	Shobach
實瑪利人	Ishmaelite
寡婦身份	widowhood
宣誓就職	sworn
宣誓就職	swearing
客西馬尼	Gethsemane
完整無缺	uncut
安菲波利	Amphipolis
安然無恙	unharmed
孩子似的	childlike
始終如一	consistently
如假包換	disguising
奴隸妻子	slave-wife
奴隸制度	slavery
女兒女婿	daughters-in-law
奧思尼爾	Othniel
夷為平地	leveled
失而復得	regained
大馬士革	Damascus
大風力量	gale-force
大規模的	massive
大搖大擺	strutted
大呼小叫	yelling
大口大口	gulps
多霧路段	fog
多數情況	inmost
士氣低落	demoralized
士氣低落	demoralize
塵土飛揚	dusty
塞浦路斯	Cyprus
塔特納伊	Tattenai
堅不可摧	impregnable
基瑪利雅	Gemariah
基希拉他	Kehelathah
基尼洗人	Kenizzites
基大老瑪	Kedorlaomer
基利波安	Gilboa
基列雅比	Jabesh-gilead
基列耶琳	Kiriath-jearim
基列耶琳	Jearim
埃萊亞薩	Eleazar
埃涅阿斯	Aeneas
埃比尼澤	Ebenezer
埃利烏德	Eliud
埃利沙巴	Elisheba
垂頭喪氣	dejected
坦率地說	frankly
圓形劇場	amphitheater
四分之一	one-fourth
嘲笑不已	scoffed
嘆了口氣	sighed
喝酒失控	guzzle
喜出望外	overjoyed
喋喋不休	nagged
喇叭播放	trumpet-playing
問心無愧	unashamed
哈馬瑣巴	Hamath-zobah
哈薩蘇塞	Hazar-susah
哈薩瑪非	Hazarmaveth
哈薩書亞	Hazar-shual
哈薩恩安	Hazar-enan
哈薩亞達	Hazar-addar
哈納尼雅	Hananiah
哈沙比雅	Hashabiah
哈大底謝	Hadadezer
哈利路亞	Hallelujah
咬牙切齒	gnashing
呼嘯而過	howls
呂底亞人	Lydians
吸引人的	appealing
吵吵嚷嚷	loudmouthed
含情脈脈	lovingly
同負一軛	yoked
同性戀者	homosexuals
合作夥伴	co-workers
合不攏嘴	crowed
可悲的是	sadly
可以預見	predictably
只有我們	Justus
古實人以	Ebed
取消資格	disqualified
反應遲鈍	unresponsive
厚顏無恥	brazen
印象深刻	impressed
卓有成效	fruitful
半蒲式耳	half-bushel
半生不熟	half-baked
午餐時間	lunchtime
十字路口	crossroads
十分之一	one-tenth
十二盎司	twelve-ounce
勢不可擋	irresistibly
勞迪西亞	Laodicea
勞苦功高	toiled
勞斯萊斯	rolls
加拉太書	Galatians
劍拔弩張	rattling
劈裡啪啦	crackling
剪切雅述	Shear-jashub
利哈比雅	Rehabiah
別有用心	ulterior
分期付款	installment
分支機構	branches
出埃及記	exodus
凱撒利亞	Caesarea
冠冕堂皇	high-sounding
再次奉獻	rededicate
其樂融融	enjoyable
全軍覆沒	annihilated
內蓋夫沙	Negev
兒子媳婦	sons-in-law
克雷森斯	Crescens
克里特島	Crete
克萊門特	Clement
克勞迪婭	Claudia
充分澆水	well-watered
元氣大傷	sapped
優柔寡斷	indecision
儘管如此	Nonetheless
傷痕累累	bruised
傳染性的	contagious
傑霍里布	Jehoiarib
傑赫卡爾	Jehucal
偷竊行為	stealing
偷偷摸摸	sneaky
偶像崇拜	idolatry
保護程序	saver
俄別以東	Obed-edom
供認不諱	confessed
來來往往	fro
使人信服	convincing
作為一個	Asa
何達威雅	Hodaviah
低三下四	cringe
伯陀迦瑪	Beth-togarmah
伯艾澤爾	Beth-ezel
伯提沙撒	Belteshazzar
伯安娜特	Beth-anath
伯伊甸園	Beth-eden
伯他普亞	Beth-tappuah
伯亞拉巴	Beth-arabah
伊麗莎白	Elizabeth
伊曼紐爾	Immanuel
伊施米萊	Ishmerai
伊施巴力	Eshbaal
伊斯拉希	Izrahiah
伊壁鳩魯	Epicurean
伊卡博德	Ichabod
伊勒哈難	Elhanan
伊利里亞	Illyricum
伊利烏賽	Eluzai
任何時候	anytime
以馬忤斯	Emmaus
以貨易貨	bartered
以色列人	Israelites
以法他人	Ephrathites
以弗所書	Ephesians
以實瑪利	Ishmaelites
以實瑪利	Ishmael
以利法列	Eliphelet
以利書亞	Elishua
以利拿單	Elnathan
以利亞敬	Eliakim
令人費解	puzzling
令人沮喪	discouraging
令人欽佩	admirable
令人欣慰	reassuring
令人擔憂	worrying
令人垂涎	coveted
令人作嘔	sickening
令人作嘔	revolting
令人不安	troubling
他們自己	themselves
他伯利們	Tabrimmon
什麼時候	when
什一奉獻	tithing
人頭攢動	thronged
人手不足	underhanded
人口調查	census
人口稠密	populated
人亞希暖	Ahinoam
交易市場	marketplaces
亞米拿達	Amminadab
亞瓦底人	Arvadites
亞比米勒	Abimelech
亞比瑪利	Abimael
亞比挪庵	Abinoam
亞比拿達	Abinadab
亞比央常	Abijam
亞比以謝	Abiezer
亞比亞撒	Abiasaph
亞歷山大	Alexandrian
亞歷山大	Alexandria
亞歷山大	Alexander
亞斯瑪威	Azmaveth
亞斯他錄	Ashtoreths
亞斯他錄	Ashtaroth
亞撒利雅	Azariah
亞摩利人	Amorite
亞得米勒	Adrammelech
亞希米勒	Ahimelech
亞希瑪斯	Ahimaaz
亞希沙哈	Ahishahar
亞希多弗	Ahithophel
亞多萊音	Adoraim
亞哈隨魯	Ahasuerus
亞利馬太	Arimathea
亞伯皂莢	Abel-shittim
亞伯拉罕	Abraham
亞伯尼歌	Abednego
五分之四	four-fifths
五分之三	three-fifths
五分之一	one-fifth
互不侵犯	nonaggression
事與願違	backfires
乃示利希	Shilhi
世界末日	Armageddon
不顧一切	recklessly
不重要的	trivial
不義之財	ill-gotten
不知所措	bewildered
不知何故	somehow
不法分子	outlaws
不斷擴大	ever-widening
不斷增加	ever-increasing
不寒而栗	shudder
不寒而栗	shivers
不孕不育	infertility
不堪重負	overwhelmed
不堪忍受	unbearable
不合理的	irrational
不可救藥	incurable
不可撤銷	irrevocable
不可接受	unacceptable
不受干擾	undisturbed
三重編織	triple-braided
三管齊下	three-pronged
三分之二	Two-thirds
三分之一	one-third
七嘴八舌	rushes
一心一意	undivided
一心一意	intently
一審宣判	verdicts
一夜暴富	flourishes
一塵不染	spotless
一同熬煮	scepters
一半份額	half-share
黛博拉	Deborah
黎巴嫩	Lebanon
黃銅匠	brazier
麵包店	bakery
麥比拉	Machpelah
魯弗斯	Rufus
魯埃爾	Reuel
魔術師	magicians
魔術師	magician
魔法師	enchanter
高質量	high-quality
高腳杯	goblets
高腳杯	goblet
驅逐艦	destroyers
驅逐艦	destroyer
驅動器	drives
騙人的	deceptive
騎著車	rode
馬耳他	Malta
馬沙爾	Mashal
馬杜克	Marduk
馬加丹	Magadan
馬其頓	Macedonian
馬其頓	Macedonia
飛行員	pilot
顯示器	displays
顯然地	apparently
顫抖的	quavering
顫巍巍	tottering
類人猿	apes
領導者	leaders
預謀的	premeditated
預言的	prophetic
預言家	seers
預言家	prophet
預言：	foresees
順風車	hitched
音樂家	musicians
音樂家	musician
革迦撒	Girgashites
革流巴	Cleopas
靠不住	untrustworthy
靠不住	unreliable
非洲人	African
非法的	illegitimate
非宗教	irreligious
非利士	Philistia
青蔥的	lush
青春的	youthful
青少年	youths
青少年	youngster
霸王鞭	rattle
霍瑟姆	Hotham
雷鳴的	thundering
雷米爾	Lemuel
雷切爾	Rachel
難得的	hard-won
離合器	clutches
離合器	clutch
雙角的	two-horned
雙胞胎	twins
雙胞胎	twin
雕刻機	engraver
集電極	collector
集裝箱	containers
集線器	hubs
雅非亞	Japhia
雅比斯	Jabez
雅朔班	Jashobeam
雅提珥	Jattir
雅挪哈	Janoah
雅弗勒	Japhlet
雅哈悉	Jahaziel
隱基底	En-gedi
陰謀家	schemers
陰謀家	conspirators
陰涼處	shade
陌生人	strangers
陌生人	stranger
附魔師	enchanters
陀迦瑪	Togarmah
陀斐特	Topheth
阿齊扎	Aziza
阿馬薩	Amasa
阿馬納	Amana
阿馬德	Amad
阿里爾	Ariel
阿邁勒	Amal
阿達爾	Addar
阿迪娜	Adina
阿貝爾	Abel
阿謝爾	Asher
阿詩瑪	Ashima
阿蘇巴	Azubah
阿莫斯	Amos
阿荷拉	Oholah
阿索斯	Assos
阿納尼	Anani
阿皮安	Appian
阿爾頓	Ardon
阿爾蒙	Almon
阿比當	Abidan
阿比林	Abilene
阿比德	Abihud
阿林巴	Olympas
阿斯旺	Aswan
阿拉德	Arad
阿拉姆	Aramaic
阿拉伯	Arabia
阿拉伯	Arab
阿扎茲	Azaz
阿德萊	Adlai
阿德納	Adna
阿帕德	Arpad
阿巴頓	Abaddon
阿巴納	Abana
阿尼安	Aniam
阿寒湖	Akan
阿姆農	Amnon
阿基姆	Akim
阿古爾	Agur
阿卡德	Akkad
阿卜達	Abda
阿卜迪	Abdi
阿博拿	Abronah
阿克爾	Achor
阮經天	Ethan
開玩笑	joking
開玩笑	fun
開心果	pistachio
閃亮的	shining
長槍兵	spearmen
長方形	rectangular
長大的	grown
鑄造廠	foundry
錫克爾	shekel
錄音機	recorder
鋪地毯	carpeted
銳利的	sharpest
銥示麥	Ir-shemesh
銀行家	bankers
針線活	sewing
金合歡	acacias
野薔薇	brier
重要性	importance
重大的	major
里茲帕	Rizpah
部落的	tribal
邁凱亞	Micaiah
邁克爾	Michael
邀請函	invitations
避風港	Havens
避風港	haven
避難所	sanctuary
避難所	sanctuaries
避難所	refuge
選擇器	picker
遮陽篷	awnings
遭天譴	sacrilegious
適時地	duly
違法者	Wrongdoers
達爾達	Darda
過路費	tolls
過路人	passerby
過時的	obsolete
運營商	carriers
運動員	athletes
運動員	athlete
逾越節	Passover
進一步	further
連衣裙	dress
連接的	connected
通行證	passes
追隨者	followers
追求的	pursued
迫擊砲	mortars
迦百農	Capernaum
迦特人	Gittite
迦步勒	Cabul
迦得人	Gadites
迦巴魯	Kebar
辯護人	defender
辦公室	office
辦事處	offices
轟隆隆	thundered
輻射的	radiant
輸卵管	Tubal
輕輕的	softly
較差的	poor
軍械庫	armory
跑步者	runner
超自然	supernatural
起重機	crane
赫爾蒙	Hermon
赫宰恩	Hezion
賽勒斯	Cyrus
賠償金	compensation
賈里德	Jared
賈卡恩	Jaakan
貿易商	traders
費解的	impenetrable
費力地	strenuously
貸款人	lenders
貸款人	lender
買回者	redeemers
貝絲車	Beth-car
貝克爾	Beker
貓頭鷹	Owls
貓頭鷹	owl
貓頭鷹	nighthawk
豐富的	teeming
豐富地	richly
豐富地	abundantly
豎琴師	harpists
讚美詩	hymns
讓我們	lets
變色龍	chameleon
警衛室	guardroom
謝爾蓋	Sergius
請願書	petitions
請享用	enjoy
諂媚的	flattering
調味料	seasoning
誹謗者	slanderers
誹謗的	slanderous
說謊者	liar
說服力	persuasive
說服了	persuaded
誘人的	tempting
誘人的	inviting
認真地	seriously
詹姆士	James
該亞法	Caiaphas
評議會	council
評論家	critic
詐騙者	racketeers
許米乃	Hymenaeus
許多色	many-colored
許可證	permits
許可證	permit
設計師	designers
設巴薩	Sheshbazzar
討厭的	loathsome
計數器	counters
計數器	counter
親戚們	relatives
親愛的	dearest
覆蓋物	coverings
西西拉	Sisera
西萊雅	Seraiah
西羅亞	Siloam
西班牙	Spain
西法瓦	Sepharvaim
西提利	Sithri
西庇太	Zebedee
西巴第	Zebadiah
西乃山	Sinai
複製品	replica
製造業	manufacturing
製造商	makers
製成的	manufactured
製作者	maker
被驅逐	evicted
被禁止	prohibited
被禁止	forbidden
被忽視	unnoticed
被定罪	convicted
表兄弟	cousins
行政的	administrative
融化了	melted
蜘蛛網	spiderweb
蛾摩拉	Gomorrah
蛇咬傷	snakebites
虔誠的	prayerful
虔誠的	devout
蘇珊娜	Susanna
藏紅花	saffron
藍寶石	sapphires
藍寶石	sapphire
薩里德	Sarid
薩迪斯	Sardis
薩莫斯	Samos
薩爾貢	Sargon
薩爾瑪	Salma
薩利姆	Salim
薛西斯	Xerxes
蓋烏斯	Gaius
蓄水池	cisterns
蒸餾出	distills
蒲式耳	bushels
蒲式耳	bushel
蒂莫西	Timothy
蒂科阿	Tekoa
葡萄酒	wines
葡萄藤	grapevines
葡萄藤	grapevine
葡萄園	vineyards
葡萄園	vineyard
葡萄乾	raisins
葡萄乾	raisin
萊納斯	Linus
菲科爾	Phicol
菲利普	Philip
華麗的	magnificent
華麗地	splendidly
莫須有	groundless
莫里亞	Moriah
莫迪凱	Mordecai
莎菲拉	Sapphira
莎樂美	Salome
莉迪亞	Lydia
荒涼的	godforsaken
艾麗卡	Elika
艾薩克	Isaac
艾哈佛	Ahava
航海的	seafaring
舒服的	comfortless
舍伯那	Shebna
舉起的	upraised
致富快	get-rich-quick
自重大	self-important
自白書	confession
自由化	freeing
自信心	self-confidence
自主性	voluntary
膚淺的	skin-deep
腳丫子	foot
腓理徒	Philetus
腓尼基	Phoenician
腓尼基	Phoenicia
腓利門	Philemon
腐敗地	corruptly
背靠背	back-to-back
背叛者	betrayer
聽起來	sounding
聯盟的	allied
聯合的	united
耶羅罕	Jeroham
耶篩亞	Jeshaiah
耶特賴	Jeatherai
耶烏施	Jeush
耶洗別	Jezebel
耶母利	Jemuel
耶書亞	Jeshua
耶斯列	Jezreel
耶拉篾	Jerahmeelites
耶弗他	Jephthah
耶布斯	Jebus
耶利米	Jeremiah
耶利摩	Jerimoth
耶利摩	Jeremoth
耶何耶	Joiada
耐心地	patiently
而不管	regardless
者禁用	forbids
老齡化	graying
翻譯員	interpreter
翻筋斗	tumbling
習慣性	customary
美聯儲	fed
美味的	delicious
羊剪毛	sheep-shearing
羅馬書	Romans
羅基琳	Rogelim
置信度	confidence
罕見的	rarer
繼承者	heir
繼承人	Heres
繼承人	heirs
繼任者	successors
繪圖儀	plotters
織布機	loom
縞瑪瑙	onyx
編譯過	complied
綠色的	grassy
綠玉髓	chrysoprase
綠松石	turquoise
綁架者	Kidnappers
統治者	rulers
統治者	ruler
絕望地	hopelessly
結構體	structure
紹洛伊	Sallai
細布業	Shebuel
累死了	worn-out
索帕特	Sopater
索多瑪	Sodom
紙莎草	papyrus
納斐塔	Naphtali
紅寶石	rubies
約雅金	Joiakim
約雅達	Jehoiada
約雅斤	Jehoiachin
約阿施	Joash
約阿施	Jehoash
約西亞	Josiah
約薩拔	Jehozabad
約瑟夫	Joseph
約沙法	Jehoshaphat
約書亞	Joshua
約撒拔	Jozabad
約拿達	Jonadab
約拿達	Jehonadab
約巴他	Jotbathah
約基別	Jochebed
約哈難	Johanan
約哈難	Jehohanan
約哈斯	Joahaz
約哈斯	Jehoahaz
紀念館	memorial
紀念章	medallions
紀念碑	monuments
紀念碑	monument
系譜的	genealogical
糊狀物	Mash
糊塗的	witless
糊塗事	stupidity
精加工	finishing
粘合劑	binder
粗暴地	harshly
粗暴地	brutally
米雅民	Mijamin
米薩合	Matred
米茲帕	Mizpah
米磯崙	Migron
米甸人	Midianites
米法押	Mephaath
米沙勒	Mishal
米沙利	Mishael
米比衫	Mibsam
米施瑪	Mishma
米斯巴	Mizpeh
米拿現	Menahem
米拉萊	Milalai
米拉約	Meraioth
米拉利	Merarites
米拉利	Merarite
米拉利	Merari
米底巴	Medeba
米基羅	Mikloth
米哈爾	Michal
米吉多	Megiddo
米利巴	Meribah
米何拉	Meholah
籠統的	sweeping
簡要地	briefly
範加爾	Gaal
管轄權	jurisdiction
管理的	managing
管理員	administrators
管理員	administrator
管理員	Admin
管理人	keeper
答比匿	Tahpenes
答比匿	Tahpanhes
等待著	awaits
第萊雅	Delaiah
第四十	fortieth
第十四	fourteenth
第十六	sixteenth
第十八	eighteenth
第十五	fifteenth
第十二	twelfth
第十九	nineteenth
第十三	thirteenth
第十七	seventeenth
第十一	eleventh
第五十	fiftieth
第二十	twentieth
第三十	thirtieth
立足點	footing
立法者	lawgiver
立方體	cube
穿長袍	robed
空閒地	idly
空談者	windbag
空談家	windbags
穩定性	stability
積極地	actively
稻草人	scarecrow
種植者	growers
種植的	planted
種子的	seed-bearing
移除了	removes
科林斯	Corinthian
科林斯	Corinth
私人的	private
禮拜堂	Bethel
福斯特	fosters
福圖納	Fortunatus
祝酒詞	toasts
祖父母	grandparents
示迦尼	Shecaniah
示米押	Shimeathites
示米押	Shimeath
示米大	Shemida
示米亞	Shimea
示瑪雅	Shemaiah
示尼珥	Senir
示孚汛	Shephuphan
磨漿機	refiner
磨損的	worn
破產者	bankrupt
破折號	dashes
破壞性	destructiveness
研究員	fellows
短暫的	transient
知道的	aware
瞭望塔	watchtowers
睫毛膏	mascara
眼鏡蛇	cobras
眼巴巴	eagerly
真正的	genuinely
真實性	truthfulness
看門狗	watchdogs
看門人	gatekeeper
看護人	caretakers
看守者	watchman
看不見	unseen
相矛盾	contradicts
相對的	relative
盲目地	blindly
目的地	destination
目擊者	witnesses
目擊者	eyewitnesses
目擊者	eyewitness
盧修斯	Lucius
監護人	guardians
監護人	guardian
監督員	overseers
盡情地	heartily
皮洛士	Pyrrhus
皮斯加	Pisgah
皮尼翁	Pinon
的疾病	sicknesses
的提交	submits
百葉窗	blinds
發霉的	moldy
發言人	spokesman
發紅的	aglow
發現的	discovers
發狂的	distraught
發狂的	Delirious
發燒的	feverish
發炎的	inflamed
發火的	ill-tempered
發明者	inventor
發明了	inventing
發光的	lit
發光的	lighted
發信號	signaling
瘋狂的	frantic
瘋狂地	Amok
痛苦的	bitterest
病懨懨	sickly
病態的	diseased
異教徒	pagans
異教徒	pagan
異教徒	heathen
用過的	used
生產的	productive
生殖器	genital
生情愫	seduces
瓦實提	Vashti
瑪西雅	Maaseiah
瑪西亞	Maaziah
瑪拿西	Manasseh
瑪基雅	Malkijah
瑪哈拉	Mahalath
瑪勒列	Mahalalel
瑪利雅	Shemariah
瑪利沙	Mareshah
琥珀色	amber
珠寶商	jewelers
珍珠母	mother-of-pearl
珍愛的	cherished
珊瑚礁	reefs
王蓮香	Susi
王室的	royal
獵戶座	Orion
獨立的	unaided
獎學金	fellowship
猶推古	Eutychus
猶尼亞	Junia
猶太教	Judaism
猶太人	Jews
狂熱者	Zealot
犯了罪	sinned
特萊姆	Telem
特羅亞	Troas
特拉人	Tirathites
特哈拿	Tirhanah
牧羊犬	sheepdogs
牧羊人	shepherds
牧羊人	shepherd
牧場饋	pasture-fed
牛膝草	hyssop
爬坡道	hill
燃燒室	firebox
熱情地	fervently
煩擾的	disturbing
煩人的	tiresome
焦急地	anxiously
無限地	infinitely
無花果	figs
無止境	unending
無敵的	unconquered
無意義	senseless
無意義	meaninglessness
無意中	unintentionally
無恥地	shamelessly
無子女	childless
無城牆	unwalled
無味的	Flavorless
無保護	unprotected
烘烤的	baked
烏西雅	Uzziah
烏拉姆	Ulam
烏利亞	Uriah
為什麼	why
灌木叢	thicket
灌木叢	bushes
濫用者	abusers
濫用的	abusive
潛伏著	lurks
漢寧波	harming
演說者	orator
滿意的	satisfying
準確性	accuracy
游泳者	swimmer
游泳的	swimming
游擊隊	guerrilla
測量學	surveying
測試儀	tester
渡渡鳥	Dodo
清障車	wreckers
添馬艦	Tamar
淹死的	drowned
混合物	mixture
深深地	dearly
淨化的	purified
浸禮者	Baptist
海岸線	shoreline
海岸線	coastline
海勒姆	Hiram
流行病	epidemics
流血的	bleeding
流浪者	wanderers
流口水	drooling
流亡者	exiles
活得比	outlived
洛伊絲	Lois
洗完澡	showered
泰特斯	Titus
注意到	Noticing
注意到	noticed
泥瓦匠	masons
波阿斯	Boaz
波羅蜜	perfections
波斯語	Persian
波斯拉	Bozrah
波斯人	Persians
波提乏	Potiphar
泛光燈	floodlight
法提雅	Ithream
法律上	legally
沙米爾	Shamir
沙烏爾	Shaul
沙比太	Shabbethai
沙母亞	Shammua
沙拉音	Shaaraim
沙得拉	Shadrach
沙勒幔	Shalman
沙利色	Sharezer
沙亞弗	Shaaph
沒頭腦	mindless
沒經驗	inexperienced
沒洗過	unwashed
沒法比	immeasurably
沒有人	nobody
沒人愛	unloved
決明子	cassia
決定性	decisive
污染者	defiler
污染物	contaminates
永遠活	ever-living
永恆的	everlasting
永動的	perpetual
毛茸茸	shaggy
毛茸茸	hairy
毛毛蟲	caterpillars
毘尼拿	Peninnah
毗萊雅	Pelaiah
毗斯巴	Pispah
毗拉心	Perazim
比羅他	Berothah
比目魚	flounders
比拿雅	Jaaziel
比拿雅	Benaiah
比多寧	Betonim
比勒達	Bildad
比加轄	Pekahiah
比利迦	Berekiah
比利亞	Beriah
每西亞	Mysia
每個人	everybody
殺無赦	unforgiven
殺人犯	murderers
殯葬業	morticians
殖民者	colonists
殖民地	colony
死一般	deathly
歷史的	historical
正確地	correctly
正當地	rightly
正式地	formally
歡樂的	festive
歐米茄	Omega
歌羅西	Colosse
欣慰的	comforting
欣喜的	delighted
橫座板	thwarts
橘紅色	jacinth
模仿者	mocker
楊千嬅	Miriam
梧桐樹	sycamores
梅默肯	Memucan
梅里德	Mered
梅拉布	Merab
梅拉姆	Merathaim
梁美芬	Priscilla
桑樹圖	sycamore-fig
桃金娘	myrtles
桃金娘	myrtle
格拉森	Gerasenes
柔軟的	soft
枯萎病	blight
板著臉	scowls
東方的	eastward
東北風	northeaster
杯狀的	cupped
杯承載	cup-bearers
杯承載	cup-bearer
李可染	Keran
朱迪思	Judith
朱迪亞	Judean
朱莉婭	Julia
本迦別	Ben-geber
本壘打	homer
本地人	native
本冰雹	Ben-hail
本傑明	Benjamin
未綁定	unbound
未稀釋	undiluted
未清除	uncleared
未染色	unstained
未收縮	unshrunk
未完成	undone
未婚妻	fiancee
未婚夫	fiances
未婚夫	fiance
未分裂	unsplit
未修剪	unpruned
木雕刻	wood-carver
朝聖者	pilgrims
服從的	submissive
服務員	attendants
服務員	attendant
有風險	risky
有角的	horned
有良心	conscientious
有興趣	interested
有約色	Igal
有活力	energetic
有沒有	hasn't
有沒有	hadn't
有毛病	amiss
有影響	influential
有幫助	helpful
有希望	promising
有希望	hopeful
有助於	contribute
有力地	forcefully
有利於	favoring
有價值	valuable
月長石	moonstone
會干擾	disturbs
最黑暗	darkest
最高的	topmost
最近的	nearest
最近的	closest
最老的	oldest
最瘋狂	wildest
最快的	fastest
最快捷	swiftest
最小的	tiniest
最好的	finest
最大膽	boldest
最大值	maximum
最南端	southernmost
最勇敢	bravest
最公平	fairest
替罪羊	scapegoat
曼德拉	mandrake
書巴業	Shubael
書亞人	Shuhite
更輕鬆	easier
更豐富	richer
更真實	truer
更清晰	sharper
更清晰	clearer
更有力	mightier
更廣泛	broader
更年輕	younger
更寬的	wider
更安全	safer
更厚的	thicker
暴風雪	snowstorm
暴風雨	tempests
暴風雨	stormy
智天使	cherubim
時間表	schedule
時令的	seasonal
是音利	Imri
是基德	Geder
是利法	Resheph
星期日	Sunday
星期五	Friday
昔蘭尼	Cyrene
易怒的	short-tempered
明確的	explicit
明確地	clearly
明白地	plainly
明智的	wise
明智的	sane
明亮地	brightly
昂船洲	stonecutters
旬迦別	Ezion-geber
旁觀者	bystanders
旁觀者	bystander
施弗拉	Shiphrah
斷路器	breakers
斯蒂芬	Stephen
斯多葛	Stoic
敵基督	antichrists
敵基督	antichrist
整流罩	shrouds
敢死隊	squads
敘利亞	Syria
救生艇	lifeboat
救世主	redeemer
敏銳的	sharp-eyed
敏銳地	keenly
放蕩的	riotous
放縱的	self-indulgent
攻擊者	attackers
攻擊者	assailant
收藏家	collectors
收割者	reapers
收割機	harvesters
收割機	harvester
支撐物	strutting
支持者	supporters
支持的	supported
攜帶的	carried
擺架子	airs
擁有者	owners
擁有的	owned
播種機	planter
播放機	player
撫慰的	soothing
撒挪亞	Zanoah
撒弗他	Sabtah
撒哈頓	Esarhaddon
撒勒法	Zarephath
撅著嘴	pouted
摩西錄	Moseroth
摩拉大	Moladah
摩利沙	Moresheth
揚聲器	speaker
提高的	elevated
提比尼	Tibni
提備斯	Thebez
提丟斯	Titius
推基古	Tychicus
接班人	successor
探照燈	searchlight
採石場	quarry
採石場	quarries
採摘的	picked
排水溝	gutter
捲起來	rolled-up
捲筒紙	web
捍衛者	defenders
挑剔的	discerning
指揮官	commanders
指揮官	commander
拿非施	Naphish
拿細耳	Nazirite
拿瑪人	Naamathite
拿撒勒	Nazareth
拿撒勒	Nazarenes
拿撒勒	Nazarene
拿哈列	Nahaliel
拿但業	Nathanael
拳擊手	boxer
拯救者	deliverers
拜偶像	Idolaters
拔示巴	Bathsheba
拉沙崙	Lasharon
拉奎拉	Aquila
拉哈德	Lahad
抽泣著	sobbed
押沙龍	Absalom
押杜亞	Jaddua
押尼珥	Abner
押利甘	Azrikam
抹大拉	Magdalene
抵抗性	resistance
抱怨的	complaining
技能的	skilled
承租人	tenant
批評者	critics
托馬斯	Thomas
打火機	lighter
打噴嚏	sneezes
打哈欠	yawning
扎哈爾	Zahar
手把手	hand-to-hand
所羅門	Solomon
所有者	owner
所有權	possession
所有權	ownership
房地產	estate
戶勒大	Huldah
我會做	Iddo
我們的	ours
我們的	our
成熟的	well-rounded
成熟的	ripened
成熟期	ripens
成年人	adults
懷疑的	incredulous
懶骨頭	lazybones
應用的	applied
憤怒地	angrily
憔悴的	gaunt
憐愛地	fondly
慣常的	accustomed
慢慢地	slowly
愛馬仕	Hermes
意大利	Italy
意大利	Italian
意味著	meant
想知道	wondering
想知道	wondered
惱人的	annoying
惡魔的	demonic
惡作劇	mischief
悶熱的	sweltering
恩臨門	En-rimmon
恩示麥	En-shemesh
恩夏瑣	En-hazor
怪念頭	whim
性急的	quick-tempered
性急的	hot-tempered
性急的	brash
怎麼樣	how
快捷鍵	shortcuts
忠實的	dutiful
忘記了	forgotten
志願者	volunteer
必要性	necessity
心碎了	brokenhearted
心理學	psychics
德馬斯	Demas
德埃爾	Deuel
復仇者	avenger
復仇的	avenging
征服者	conqueror
彼拉多	Pilate
彌賽亞	messiahs
彌賽亞	Messiah
彌敦道	Nathan
強烈地	mightily
強化劑	strengthens
弓箭手	archers
建設者	builders
建設者	builder
建設性	constructive
建築師	architect
延期的	deferred
廢棄的	deserted
座右銘	motto
底比斯	Thebes
底本迦	Dibon-gad
幾乎不	hardly
平靜的	peaceful
幫幫我	help
帖土羅	Tertullus
帕福斯	Paphos
帕提亞	Parthians
帕塔拉	Patara
帕加馬	Pergamum
希西家	Hezekiah
希臘講	Greek-speaking
希臘語	Greek
希臘人	Greeks
希羅底	Herodias
希斯崙	Hezron
希斯倫	Hezronites
希實本	Heshbon
希勒爾	Hillel
希利斯	Helez
希伯倫	Hebronites
希伯倫	Hebron
布蘭妮	spears
布萊特	bleat
布基雅	Bukkiah
巴魯克	Baruch
巴西萊	Barzillai
巴西亞	Paseah
巴比倫	Babylonian
巴比倫	Babylonia
巴比倫	Babylon
巴拿巴	Barnabas
巴拉巴	Barabbas
巴拉克	Barak
巴拉但	Baladan
巴戶琳	Bahurim
巴忒羅	Pathros
巴弗提	Epaphroditus
巴底買	Bartimaeus
巴力迦	Baal-gad
巴力瑪	Baal-tamar
巴利亞	Bariah
巴別塔	Babel
已備份	backed
左撇子	left-handed
工作日	workdays
嵌入式	embedded
崇高的	exalted
崇拜者	worshipers
崇拜者	worshiper
山羊皮	goatskin
居里扭	Quirinius
尼羅河	Nile
尼細亞	Neziah
尼格爾	Nergal
尼普心	Nephusim
尼拜約	Nebaioth
尼尼微	Nineveh
尼姆肖	Nimshi
尼哥拉	Nicolaitans
尼哥大	Nekoda
尼利雅	Neariah
尼利亞	Neriah
尼利亞	Nereus
尤尼斯	Eunice
尤利爾	Uriel
尖叫聲	screams
小齒輪	pinions
小茴香	cumin
小牝牛	heifer
小人物	nobodies
導致尖	lead-tipped
導向器	director
對抗地	defiantly
尊敬的	respectful
尊敬的	admired
專業的	professional
實提莫	Eshtemoa
富裕的	opulent
密封件	seals
寄存器	registers
寄存器	register
宣稱的	proclaimed
定居點	settlements
定居者	settlers
定位的	positioned
安納斯	Annas
安提阿	Antioch
安提帕	Antipatris
安提帕	Antipas
安息日	Sabbaths
安息日	Sabbath
安德魯	Andrew
安娜特	Anath
守望者	watchmen
守望者	watcher
學生們	students
學到了	learned
孫申利	Shimri
孟菲斯	Memphis
娜奧米	Naomi
威瑟斯	withers
姆納森	Mnason
她自己	herself
女王的	queenly
女人的	Woman’s
奮鬥的	struggling
奧馬里	Omri
奧馬爾	omer
奧馬爾	Omar
奧貝德	Obed
奧古斯	Augustus
奧利布	Oholiab
奧克斯	oaks
奢侈品	luxuries
奔欣嫩	Ben-hinnom
奔佐斯	Ben-zoheth
失業的	unemployed
太巴列	Tiberias
天花板	ceilings
天花板	ceiling
大篷車	caravans
大篷車	caravan
大盤子	platter
大理石	marble
大熱天	scorcher
大流士	Darius
大比雅	Nedabiah
大比拉	Daberath
大拇指	thumbs
大嘴巴	loudmouth
大利拉	Delilah
夢想家	visionaries
夢想家	dreamers
夢想家	dreamer
多雲的	cloudy
多雨的	rainy
多比雅	Tobijah
多比雅	Tobiah
多尼雅	Adonijah
多卡斯	Dorcas
多刺的	thorny
外邦人	Gentiles
外邦人	Gentile
外行人	laypeople
外星人	aliens
外國人	foreigners
外國人	foreigner
士麥那	Smyrna
壞透地	wickedly
壞血病	scurvy
壓迫者	oppressors
填充的	stuffed
塞達斯	Theudas
塞繆爾	Samuel
塞爾斯	sells
塞拉芬	seraphim
塞拉斯	Silas
塞勒姆	Salem
塔穆茲	Tammuz
塔爾蒙	Talmon
塔比瑟	Tabitha
堅革哩	Cenchrea
基金會	foundations
基納斯	Kenaz
基督教	Christianity
基督教	Christian
基督徒	Christians
基比頓	Gibbethon
基比亞	Gibeah
基母利	Kemuel
基拉萊	Maai
基德隆	Kidron
基底莫	Kedemoth
基尼烈	Kinnereth
基土拉	Keturah
基哈西	Gehazi
基利提	Kerethites
基利心	Gerizim
基利家	Cilicia
基利他	Kelita
基列亭	Kiriathaim
基低羅	Gederoth
基伊拉	Keilah
埃胡德	Ehud
埃澤爾	Ezer
埃洛伊	Eloi
埃德爾	Eder
埃及人	Egyptians
埃及人	Egyptian
埃利澤	Eliezer
埃什唐	Eshton
地平線	horizon
地中海	Mediterranean
在高處	aloft
在腳下	underfoot
在旁邊	aside
在戶外	outdoors
在位的	reigning
土富撒	Tryphosa
圍繞著	surrounds
固執地	stubbornly
回憶錄	memoirs
回力鏢	boomerangs
四十五	forty-five
四十二	forty-two
四十三	forty-three
四十一	forty-one
嚴厲的	harsher
嚇壞了	terrifies
嚇壞了	horrified
嘲笑聲	jeers
嘲笑者	scoffers
單戶篾	Tanhumeth
喬納森	Jonathan
喬安娜	Joanna
喘著氣	panted
喇叭手	trumpeter
喇叭形	flared
喃喃地	murmured
啤酒琳	Beer-elim
唱詩班	choir
哲學家	philosophers
哪一個	which
哥斯比	Cozbi
哈魯斯	Haruz
哈達薩	Hadassah
哈迪德	Hadid
哈蘇巴	Hasupha
哈腓拉	Havilah
哈納尼	Hanani
哈洗錄	Hazeroth
哈母勒	Hamul
哈巴谷	Habakkuk
哈多蘭	Hadoram
哈哥斯	Hakkoz
哈勒爾	Harar
哈內斯	Hanes
哈他革	Hathach
咸豬手	groping
和藹地	graciously
和平祭	peace-offering
和事佬	peacemaker
呂高尼	Lycaonia
呂貝卡	Rebekah
吹牛的	braggart
向內的	inward
同性戀	homosexuality
吉迪恩	Gideon
吉吧珥	Gibbar
吉利德	Gilead
合適的	suited
合法的	rightful
合唱團	choirs
司號員	bugler
司提反	Stephanas
司令部	headquarters
可能性	possibility
可能性	odds
可理解	understandable
可怕的	terrifying
可怕的	frightening
可怕的	fearsome
可怕的	dreaded
可得到	available
可前往	navigates
叮噹聲	tinkle
叮噹聲	clanging
另一個	another
古示人	Cushi
受影響	affected
受害者	victims
受害者	victim
受威脅	threatened
取代了	supplants
反射的	reflected
友阿爹	Euodia
參巴拉	Sanballat
厭惡的	disgusted
原版的	original
危險的	threatening
印刷機	presses
卡迪什	Kadesh
卡梅爾	Carmel
占星家	astrologers
占星家	astrologer
占卜者	diviners
南部的	southern
協西巴	Hephzibah
半支派	half-tribe
升降機	lifts
十字架	crosses
十六歲	sixteen-year-old
十二月	December
區域性	regional
化妝水	lotions
化合物	compounds
包裝袋	bags
包裝紙	wrappings
包裝箱	crates
勞動者	laborers
勞動力	labors
勝利者	victor
勝利地	triumphantly
勇敢地	bravely
劫持者	captors
努伊勒	Penuel
助產士	midwives
助產士	midwife
加略人	Iscariot
加爾丁	Chaldean
加拉爾	Galal
加拉太	Galatia
加利奧	Gallio
加利利	Galilee
加利利	Galileans
加利亞	Kareah
劊子手	executioners
劊子手	executioner
創造者	Creator
創辦人	founder
創始人	founders
剪羊毛	shearers
前任的	former
刻錄機	burners
刻錄機	burner
刮鬍子	shave
利非訂	Rephidim
利雅大	Eliada
利西亞	Lycia
利薩巴	Elzabad
利維坦	Leviathan
利米勒	Elimelech
利瑪利	Remaliah
利法雅	Rephaiah
利沙瑪	Elishama
利比拉	Riblah
利比亞	Libyans
利比亞	Libya
利未記	Levitical
利未人	Levites
利未人	Levite
利撒反	Elizaphan
利提瑪	Rithmah
利巴拿	Lebanah
利巴力	Elpaal
利克希	Likhi
利來雅	Reelaiah
利以謝	Elioenai
利亞雅	Reaiah
利亞利	Elealeh
利乏音	Rephaites
利乏音	Rephaim
判決書	verdict
初學者	beginner
切碎的	chopped
分散式	distributed
分成小	portioned
出納員	treasurer
凱斯亞	Keziah
冷回火	cool-tempered
冷冰冰	frosty
再保證	reassure
共混物	blends
六十五	sixty-five
公正的	fair-minded
公正地	justly
公務員	servants
八布迦	Bakbukiah
八十四	eighty-four
八十五	eighty-five
八十三	eighty-three
全新的	brand-new
內厄姆	Nahum
入侵者	invaders
免疫的	immune
克里特	Cretans
克洛伊	Chloe
光明節	Hanukkah
光刻膠	resists
先見者	seer
先生們	Sirs
先生們	Gentlemen
儲藏室	storerooms
僱傭兵	mercenaries
傾斜的	pitched
債權人	creditors
債權人	creditor
債務人	debtors
傳福音	evangelists
傳染病	infectious
傳播者	Evangelist
備忘錄	Memorandum
傑里科	Jericho
傑迪達	Jedidah
傑思羅	Jethro
傑希勒	Jehiel
傑出的	distinguished
偽君子	hypocrites
偽君子	hypocrite
偵察兵	scouts
偏遠的	remotest
假裝的	pretended
借款人	borrowers
借款人	borrower
候車亭	shelters
倖存者	survivors
倖存者	survivor
個別地	individually
俱樂部	club
信號旗	waft
信任的	trusting
信任地	confidentially
保險槓	bumper
保護者	protector
保護的	protective
保盧斯	Paulus
保留的	reserved
保守的	sparing
俗世的	earthly
俄珥巴	Orpah
俄斐勒	Ophel
俄弗拉	Ophrah
俄巴底	Obadiah
便以利	Peniel
依賴的	dependent
佩雷斯	Perez
你自己	yourselves
你自己	yourself
何罪？	neglecting
何細亞	Hoshea
何珥瑪	Hormah
何弗尼	Hophni
何利人	Horites
佔比達	Bedad
低聲道	whispered
伽利略	Galilean
伴隨著	accompanied
伯里亞	Berea
伯賽大	Bethsaida
伯蔽日	Beth-biri
伯聖地	Beth-haram
伯米羅	Beth-millo
伯米恩	Beth-meon
伯示麥	Beth-shemesh
伯沙撒	Belshazzar
伯毗珥	Beth-peor
伯毗力	Beth-pelet
伯曷拉	Beth-hoglah
伯微漲	Beth-eked
伯尼斯	Bernice
伯寧拉	Beth-nimrah
伯大袞	Beth-dagon
伯大尼	Bethany
伯哈蘭	Beth-haran
伯和崙	Beth-horon
伯吉甲	Beth-gilgal
伯利恆	Bethlehem
伯利合	Beth-rehob
伯亞文	Beth-aven
休息室	lounge
伊萊休	Elihu
伊胡得	Jehud
伊示雅	Isshiah
伊示雅	Ishijah
伊甸園	Eden
伊特瑪	Ithmah
伊比利	Ibri
伊施波	Ishbosheth
伊提南	Ethnan
伊利達	Eldad
伊利爾	Eliel
任何人	whomever
任何人	anyone
任何人	anybody
以革倫	Ekron
以賽亞	Isaiah
以薩迦	Issachar
以色列	Israels
以色列	Israelite
以色列	Israel
以法蓮	Ephraimites
以法蓮	Ephraim
以法他	Ephrath
以比贊	Ibzan
以斯本	Ezbon
以斯拉	Ezra
以斯帖	Esther
以斯哈	Izhar
以挪士	Enosh
以拉他	Elath
以弗所	Ephesus
以弗所	Ephesian
以巴弗	Epaphras
以實陶	Eshtaol
以利法	Eliphaz
以利沙	Elishaphat
以利沙	Elisha
以利撒	Elzaphan
以利押	Eliab
以利亞	Elijah
以利亞	Eliashib
代表團	delegation
代用品	substitutes
代理人	agent
他自己	himself
他普亞	Tappuah
他提雅	Mattithiah
他帶領	Heled
他利亞	Tahrea
他備拉	Taberah
他們的	theirs
他們會	they'll
什巴克	Ishbak
什一稅	tithes
人中有	Sallu
亦施瓦	Ishvah
交響樂	symphony
交杯酒	wedlock
亞雅崙	Aijalon
亞遍。	Appaim
亞迦布	Agabus
亞該亞	Achaia
亞西加	Azekah
亞米忽	Ammihud
亞米利	Ammiel
亞祿有	Aloth
亞瑪力	Amalekite
亞玻倫	Apollyon
亞波羅	Apollos
亞法撒	Arphaxad
亞比雅	Abijah
亞比蘭	Abiram
亞比篩	Abishai
亞比戶	Abihu
亞杜蘭	Adullamite
亞杜蘭	Adullam
亞撒黑	Asahel
亞摩斯	Amoz
亞摩利	Amorites
亞提馬	Artemas
亞拿突	Anathoth
亞拔他	Abagtha
亞拉臘	Ararat
亞拉篾	Alemeth
亞拉巴	Arabah
亞必迭	Abdiel
亞德別	Adbeel
亞得列	Adriel
亞帥雅	Asaiah
亞希約	Ahio
亞希突	Ahitub
亞希摩	Ahimoth
亞希忽	Ahihud
亞希幔	Ahiman
亞希以	Ahiezer
亞希亞	Ahijah
亞希亞	Ahiah
亞實突	Ashdodites
亞大雅	Adaiah
亞大錄	Ataroth
亞基老	Archelaus
亞基布	Archippus
亞哈謝	Ahaziah
亞哈斯	Ahaz
亞勞拿	Araunah
亞利耶	Arieh
亞伯蘭	Abram
五旬節	Pentecost
五山送	Gozan
五十五	fifty-five
二把手	second-in-command
二十四	twenty-four
二十五	twenty-five
二十二	twenty-two
二十九	twenty-nine
二十三	twenty-three
二十七	twenty-seven
二十一	twenty-one
二十一	twenty-first
了不起	terrific
亂收費	overcharged
丹尼爾	Daniel
丹家安	Dan-jaan
中隔離	separates
中間人	mediator
中山裝	tunic
丟特腓	Diotrephes
不鼓勵	discourage
不需要	unwanted
不重要	unimportant
不適當	unfit
不道德	immoral
不贊成	disapproval
不誠實	dishonesty
不誠實	dishonestly
不誠實	dishonest
不要臉	shameless
不舒服	discomfort
不耐煩	impatient
不經意	carelessly
不穩定	unstable
不確實	untrue
不確定	uncertainty
不確定	uncertain
不知道	unaware
不甘心	reconciled
不滿意	unsatisfied
不服從	disobedience
不成功	unsuccessful
不愉快	displeasure
不快樂	unhappy
不忠的	disloyal
不忠實	disloyalty
不必要	unnecessary
不必要	needless
不害怕	unafraid
不完美	imperfectly
不和諧	tuneless
不同意	disagreeing
不同意	disagreed
不同意	disagree
不合理	unreasonable
不可能	impossible
不可控	uncontrollable
不反對	unopposed
不友好	unfriendly
不動搖	unmoved
不公正	unjustly
不公正	injustice
不公平	unfairly
不公平	unfair
不值得	unworthy
不值得	undeserving
下腳料	scraps
下放大	enlarges
下一個	next
上撒們	Zalmon
上下文	context
三文魚	Salmon
三十歲	three-year-old
三十四	thirty-four
三十二	thirty-two
三十九	thirty-nine
三十三	thirty-three
三十七	thirty-seven
三十一	thirty-one
七弦琴	lyre
七十五	seventy-five
七十二	seventy-two
七十七	seventy-seven
丁字褲	thongs
丁字褲	thong
一部分	portion
一歲鴿	yearlings
一會兒	awhile
一巴掌	spank
一分錢	penny
齒輪	gear
齋戒	fasts
齊奏	unison
鼻音	snorting
鼻環	nose-ring
鼻孔	nostrils
鼻子	noses
鼻子	nose
鼻吸	snuffing
鼠疫	plague
鼓起	Muster
鼓勵	encourages
鼓勵	encouragement
鼓勵	encouraged
鼓勵	encourage
黴菌	mildew
點頭	Nod
點燃	kindled
點燃	kindle
點燃	ignites
點燃	ignite
點火	igniting
點擊	hits
點亮	illuminates
黛娜	Dinah
默默	silently
黑馬	Hermas
黑豹	panthers
黑色	black
黑甲	Helkath
黑暗	darkness
黑暗	darkened
黑暗	dark
黑暗	blackest
黑幫	Gangs
黎明	dawns
黎明	dawn
黃蜂	hornets
黃色	yellow
黃瓜	cucumbers
黃玉	topaz
黃牛	cattle
黃昏	nightfall
黃昏	dusk
麻風	leprous
麻風	leprosy
麻雀	sparrows
麻雀	sparrow
麻袋	sacks
麻煩	troubles
麻煩	trouble
麻木	stupor
麻布	sackcloth
麻布	linen
麵糊	batter
麵粉	flour
麵團	dough
麵包	loaves
麵包	loaf
麵包	breads
麵包	bread
麥西	Mizraim
麥基	Melki
麥地	grainfields
鹼液	lye
鸕鶿	cormorant
鷹派	hawks
鷓鴣	partridge
鵪鶉	quail
鴿子	pigeons
鴿子	pigeon
鴿子	doves
鴿子	dove
鴕鳥	ostriches
鴕鳥	ostrich
鳴叫	chirping
鳳凰	Phoenix
鳥類	birds
鱷魚	crocodile
鰭片	fins
魯莽	reckless
魯本	Reuben
魚鷹	osprey
魚叉	harpoon
魔鬼	devil
魔法	magic
魅力	charms
魅力	charm
魄力	boldness
鬧鬼	haunted
鬧劇	farce
鬧事	troublemakers
鬥爭	struggle
鬥爭	fight
鬣狗	hyenas
鬍鬚	beards
鬍子	beard
鬆開	loosen
鬆口	relent
鬆動	loosed
鬃毛	mane
髮型	hairstyles
高音	blaring
高遠	lofty
高超	superb
高貴	noble
高舉	exalts
高興	thrilled
高興	glee
高興	glad
高聲	loudly
高聲	aloud
高級	high-ranking
高級	advanced
高潮	climax
高格	Gog
高強	excel
高度	highly
高度	heights
高度	height
高地	highlands
高呼	chanted
高原	plateaus
高原	plateau
骷髏	skeletons
骰子	dice
骯髒	unclean
骨頭	bones
骨架	framework
骨幹	backbone
骨刺	spur
驚駭	fright
驚醒	roused
驚醒	awakened
驚訝	astonished
驚慌	alarmed
驚愕	amazement
驚奇	amaze
驚嚇	terrify
驚嚇	startle
驚嘆	marveling
驚嘆	marveled
驚呼	exclaimed
驚叫	scream
驚人	astounding
驚人	amazing
驗證	verified
驗證	validated
驗收	accepting
驗收	acceptance
驕傲	proud
驅逐	expels
驅逐	expelling
驅逐	expel
驅蟲	wormed
驅動	driven
騾子	mules
騷擾	harassing
騷擾	harassed
騷擾	harass
騷動	uproar
騷動	tumult
騷動	commotion
騷亂	rioting
騙局	deception
騙子	swindlers
騙子	swindler
騙子	liars
騙子	impostors
騙子	deceivers
騙子	deceiver
騙子	cheaters
騙取	defraud
騎術	riding
騎士	rider
騎兵	cavalry
駱駝	camels
駱駝	camel
駭然	aghast
駝背	stooped
駕駛	drive
駕馭	harnessed
駐軍	garrisons
駐軍	garrison
駐留	dwells
駁斥	refuted
駁回	dismissed
馴服	tamed
馴服	tame
馳騁	gallop
馬騾	mule
馬賽	Maasai
馬薩	Massa
馬槽	manger
馬拉	Mara
馬岱	Madai
馬尾	Cauda
馬夫	groom
馬塔	Matthat
馬厩	stables
馬匹	horses
馬兵	horsemen
馬倫	Mahlon
馬俱	harness
馬修	Matthew
馬但	Matthan
香香	savory
香菜	coriander
香脂	balsam
香脂	balm
香甜	soundly
香爐	censers
香水	perfumes
香水	perfume
香水	fragrances
香氣	aroma
香料	spices
香料	spice
香味	scent
香味	fragrance
香包	sachet
首飾	ornaments
首飾	jewelry
首都	capitals
首都	capital
首腦	summit
首席	chief
首富	richest
饞嘴	glutton
饒恕	forgiveness
饋送	feeding
餘燼	embers
餓死	starve
餐飲	food
餐具	utensils
養護	curing
養肥	fattened
養殖	farmed
飾面	finishes
飾品	accessories
飼養	rearing
飼養	reared
飼料	fodder
飼料	feed
飲食	diet
飲酒	drinkers
飲料	drinks
飲料	beverage
飢餓	starved
飢餓	starvation
飢餓	hungry
飢餓	hunger
飢荒	famines
飢荒	famine
飢渴	hungrily
食草	grass-eating
食慾	appetite
食品	foods
食人	man-eater
飛鏢	darts
飛躍	leaps
飛躍	leaped
飛躍	leap
飛行	flying
飛行	flown
飛行	flight
飛蛾	moths
飛濺	splatters
飛濺	splatter
飛散	spattered
飛奔	darted
飄飄	fluttering
飄零	wandering
颶風	hurricane
颱風	typhoon
風靡	swept
風險	risks
風險	risk
風選	winnowing
風茄	mandrakes
風箱	bellows
風箏	kites
風暴	windstorm
風暴	storms
風暴	storm
風扇	fan
風化	weathered
顯示	shown
顯示	showed
顯示	show
顯示	displaying
顯示	displayed
顯示	display
顫抖	trembles
顫抖	trembled
顫抖	tremble
顫抖	thrill
顫抖	quivers
顫抖	quivered
顫動	quiver
顧客	customers
顧問	counselor
顧問	advisers
顧問	adviser
類型	types
類型	type
類似	similar
類似	resembling
類似	resemble
顛覆	overturn
願景	visions
願意	willing
顏色	color
顎骨	jawbone
額頭	foreheads
額外	extra
額外	additional
題詞	inscription
頻繁	frequent
頹唐	deserting
頸部	neck
頭髮	hair
頭骨	skulls
頭骨	skull
頭飾	headdresses
頭腦	minds
頭目	ringleaders
頭目	ringleader
頭盔	helmets
頭盔	helmet
頭帶	headbands
頭巾	turbans
頭巾	turban
領班	foreman
領帶	tie
領導	leading
領導	leadership
領導	leader
領域	realm
領域	fields
領域	field
領土	territory
領土	territories
領主	lords
頒布	enacted
頑固	obstinate
預賽	heats
預計	projected
預計	expects
預計	estimated
預計	anticipates
預言	prophesying
預言	prophesy
預言	prophesies
預言	prophesied
預言	prophecy
預言	prophecies
預言	foretold
預示	foretaste
預示	foreshadowed
預測	predicts
預測	predictions
預測	prediction
預測	predicting
預測	predict
預期	expected
預期	anticipation
預塗	prefinished
預先	beforehand
預兆	omens
順利	successfully
順利	smoothly
順便	Incidentally
項鍊	necklaces
項鍊	necklace
項目	projects
項目	project
項目	items
項目	item
頂替	displace
頂住	withstood
響板	castanets
響應	response
響應	responds
響應	responding
響應	respond
響徹	resounded
韻律	rhythm
音麥	Immer
音箱	speakers
音樂	musical
音樂	music
音拿	Imnah
韭菜	leeks
韓元	won
韋弗	weaver
鞭打	whipped
鞭打	flogged
鞭打	flog
鞭子	whips
鞭子	whip
鞠躬	bowing
鞠躬	bowed
革順	Gershonites
革順	Gershonite
革舜	Gershom
面紗	veils
面紗	veiling
面紗	veil
面皮	skinned
面板	panels
面料	fabrics
面對	facing
面對	faced
面對	face
面對	confronts
面對	confronted
面對	confront
面孔	faces
面前	front
面具	masks
非難	reproof
非難	condemnation
非禮	indecent
非神	non-gods
非法	illegal
非常	very
非常	strongly
非常	immensely
非常	greatly
非常	extremely
非常	exceedingly
靜音	mute
青銅	bronze
青蛙	frogs
青睞	favored
青年	youth
靈魂	souls
靈魂	soul
靈感	inspiration
靈性	spiritually
靈性	spirituality
霸道	overbearing
露營	camping
露台	terraces
露出	outcrop
霍隆	Holon
震驚	astounded
震撼	shook
震撼	rocked
需要	takes
需要	required
需要	needed
需要	need
需要	demands
需求	requirement
需求	needs
需求	demand
電路	circuit
電話	calls
電流	currents
電梯	lift
雹暴	hailstorm
雷雲	thundercloud
雷暴	thunderstorms
雷巴	Reba
雷卡	Racal
雲集	gathered
雲母	Mica
雪白	whitest
雪橇	sledges
雪橇	sledge
雪松	cedarwood
雪松	cedars
雪松	cedar
雪城	Syracuse
雨量	rainfall
難量	defies
難民	refugees
難民	refugee
難忘	unforgettable
離開	leaving
離開	leave
離開	departure
離開	depart
離棄	forsaken
離婚	divorces
離婚	divorced
離婚	divorce
雜質	impurities
雜草	weeds
雛鳥	nestlings
雙面	sided
雙方	sides
雙刃	double-edged
雖然	though
雖然	Nevertheless
雖然	although
雕刻	engraving
雕刻	engrave
雕刻	carvings
雕刻	carving
雕刻	carver
雕刻	carve
雕像	statues
雕像	statue
雇農	farmhands
雇主	employer
集群	clusters
集合	congregation
集合	assemble
集中	concentrate
雅雜	Jahaz
雅金	Jakim
雅述	Jashub
雅買	Jahmai
雅謝	Jazer
雅蘭	Jalam
雅薛	Jahzeel
雅立	Jarib
雅比	Jabesh
雅斤	Jakin
雅敬	Jehoiakim
雅拉	Jaalah
雅弗	Japheth
雅幹	Jorai
雅尼	Jannes
雅善	Jashen
雅哈	Jahath
雅各	Jacob
雅博	Jabbok
雅利	Jahleel
雅典	Athens
雅典	Athenians
雅億	Jael
雅代	Jahdai
雄辯	eloquent
雄偉	majestic
隸屬	subjection
隱藏	hide
隱藏	conceal
隱藏	buried
隱私	privacy
隱形	cloaked
隱士	recluse
隨機	randomly
隨地	anywhere
隨同	accompanying
隨你	whatever
隧道	tunnels
隧道	tunnel
障礙	obstacles
障礙	obstacle
障礙	impediment
隘路	defiles
隔離	seclusion
隔離	quarantined
隔離	quarantine
隔離	isolation
隔山	Geshan
階段	stages
隊長	captain
隊友	teammate
隊伍	contingent
隆隆	rumbling
隆隆	rumble
隆重	grandly
隆冬	midwinter
陽台	terrace
陽光	sunshine
陽光	sunlight
陽光	Rays
陽光	daylight
陷阱	traps
陷阱	trap
陷害	framed
陶醉	reveling
陶醉	revel
陶工	potters
陶器	pottery
陰謀	conspiracy
陰謀	conspiracies
陰莖	penis
陰沉	gloomy
陰影	shadows
陰影	shadow
陰影	shading
陰影	shaded
陰唇	Nympha
除非	unless
除了	besides
陣雨	showers
陣痛	pangs
限制	restrictions
限制	restriction
限制	limiting
限制	limitations
限制	limit
降雨	rains
降解	degrading
降落	landing
降落	descent
降落	descend
降臨	befalls
降脂	lowing
降級	relegated
降低	lowered
降低	lower
陌生	unfamiliar
附近	vicinity
附近	nearby
附庸	vassal
附件	enclosure
附上	attaching
陀臘	Tolad
陀弗	Tophel
阿鮮	Ozem
阿霍	Ahoah
阿隆	Allon
阿門	amen
阿迪	Addi
阿諛	flattery
阿蘭	Aran
阿蒙	Amon
阿蒙	Ammon
阿美	Ami
阿米	Ammi
阿科	Acco
阿斐	Ophir
阿拉	Ahira
阿扎	Arza
阿德	Ard
阿希	Ahi
阿巴	Abba
阿山	Ashan
阿尼	Arni
阿吉	Agee
阿南	Onam
阿南	Anan
阿伯	Oboth
阻礙	hinders
阻礙	hinder
阻撓	frustrate
阻力	hindrance
防腐	embalming
防禦	defenses
防禦	defense
防水	waterproofed
防止	prevents
防止	preventing
防止	prevented
防搶	snatches
闢罕	Bilhan
闢拉	Bilhah
闡述	elaborate
關閉	shutting
關閉	shut
關閉	closing
關閉	closes
關閉	closed
關聯	associating
關聯	associate
關節	joints
關注	concerns
關於	regarding
關於	concerning
關於	about
關心	concerned
關心	concern
關心	care
關係	relationships
關係	relationship
關係	relations
關係	relation
闊氣	lavish
閾值	thresholds
閹割	castrated
閨房	Harim
閨房	harem
閣樓	attic
閣下	Excellency
間隙	gap
間諜	spy
間諜	spies
間斷	interrupted
閒聊	gossiping
開陽	Mizar
開除	expelled
開關	switches
開釋	acquittal
開釋	acquit
開車	drove
開裂	cracking
開花	flowering
開花	blossoms
開花	blossomed
開花	blossom
開盤	opening
開明	enlightened
開支	spending
開採	quarried
開採	mined
開幕	inaugurate
開始	starting
開始	started
開始	start
開始	begun
開始	begins
開始	beginnings
開始	beginning
開始	begin
開始	began
閃電	lightning
閃著	glowed
閃耀	shined
閃耀	shine
閃耀	blazed
閃現	flashed
閃爍	twinkling
閃爍	glitters
閃爍	flickering
閃爍	flashing
閃爍	flashes
閃爍	blinking
閃光	gleam
閃光	flare
閃亮	shiny
門階	doorstep
門道	doorways
門納	Menna
門牌	unnumbered
門框	doorposts
門框	doorframes
門框	doorframe
門柱	gateposts
門柱	gatepost
門房	doorkeeper
門廳	foyers
門廳	foyer
門廊	porches
門廊	porch
門口	doorway
長袍	tunics
長袍	robes
長袍	robe
長舌	blabbermouth
長老	elders
長老	elder
長笛	flute
長椅	couch
長度	length
長官	officers
長女	firstborn
長嘯	shouts
鑿成	hewn
鑽進	sneaks
鑽石	diamond
鑲板	paneling
鑲板	paneled
鑲嵌	mosaic
鑲嵌	inlaid
鑑定	identify
鑑定	identification
鑄工	molder
鑄件	casts
鑄件	casting
鐵青	ashen
鐵桿	irons
鐵匠	smiths
鐵匠	blacksmiths
鐵匠	blacksmith
鐮刀	sickles
鐮刀	sickle
鐘聲	bells
鐐銬	shackles
鏡子	mirrors
鏡子	mirror
鏈接	chained
鎮定	calms
鎖定	locked
鍛造	forging
鍛造	forge
錯開	stagger
錯過	misses
錯過	missed
錯誤	wrong
錯誤	mistakes
錯誤	mistaken
錯誤	mistake
錯誤	errors
錯誤	error
錨定	anchored
錢包	wallet
錘子	hammer
錐子	awl
鋼筆	pen
鋼廠	mills
鋼包	ladles
鋪設	laying
鋪設	lay
鋪設	laid
銷毀	destroying
銷毀	destroyed
銷售	selling
銳化	sharpens
銳化	sharpening
銅蛇	Nehushtan
銅匠	coppersmith
銀行	banks
銀行	bank
銀匠	silversmiths
銀匠	silversmith
鉸鏈	hinges
鈴聲	ringing
釣魚	fishing
針織	knit
針對	directed
針對	aimed
釘死	crucifying
釘死	crucify
釘子	nails
金融	financial
金色	golden
金庫	treasury
金屬	metals
金屬	metal
金匠	goldsmiths
金匠	goldsmith
野蠻	uncivilized
野蠻	brutal
野蠻	barbaric
野花	wildflowers
野生	wild
野兔	hare
重量	weight
重要	vital
重要	important
重複	repeats
重複	repeating
重複	repeated
重複	repeat
重聚	reunited
重組	regrouped
重疊	overlapping
重申	reaffirm
重生	reborn
重新	anew
重新	afresh
重擊	pounding
重建	reestablished
重建	reestablish
重建	reconstruction
重建	reconstructed
重建	rebuilt
重建	rebuilding
重建	rebuild
重大	significant
里森	Resen
釋放	freed
釀造	brewed
醫生	doctors
醫生	doctor
醫治	healings
醫師	physicians
醫師	physician
醫學	medicine
醜陋	ugly
醜聞	scandal
醜惡	repulsive
醒來	woke
醒來	waking
醉鬼	drunks
醉人	intoxicating
醇香	sweet-smelling
酸奶	yogurt
酷熱	scorching
酵母	yeast
酣暢	snorts
酒鬼	drunkards
酒鬼	drunkard
酒館	taverns
酒醉	drunkenness
酒精	alcoholic
酒榨	winepresses
酒榨	winepress
酒徒	drinker
酒吧	bars
酒吧	bar
配額	quotas
配額	quota
配股	allotment
配給	ration
配料	ingredients
配售	placing
配合	mated
配偶	spouses
配件	fitting
酋長	chiefs
鄰里	neighborhood
鄰接	neighboring
鄰居	neighbors
鄰居	neighbor
鄙視	despises
鄙視	despised
鄙視	contempt
鄉村	rural
郵票	stamp
郵件	mail
部長	ministers
部長	minister
部落	tribes
部落	tribe
部落	horde
部署	deployed
部分	sections
部分	section
部分	parts
部分	part
部件	assembly
郊區	outskirts
邪惡	wickedness
邪惡	wicked
邪惡	unholy
邪惡	evil
那裡	there
那些	those
那些	ones
邏輯	logic
邊遠	outlying
邊緣	verge
邊緣	fringe
邊緣	edges
邊緣	edge
邊緣	brink
邊界	bounding
邊界	boundary
邊界	boundaries
邊境	frontier
邊境	border
還款	repayment
邁拉	Myra
邀請	invites
邀請	invited
邀請	invite
避免	prevent
避免	Avoiding
避免	avoided
避免	avoid
避免	avert
避免	abstain
遺跡	remains
遺產	inheritance
遺產	heritage
遺傳	inherited
選擇	selects
選擇	select
選擇	picking
選擇	chosen
選擇	chose
選擇	choosing
選擇	choose
選擇	choices
選擇	choice
遷移	migrated
遵守	obey
遵命	obeyed
遲疑	hesitate
遲早	Sooner
遭遇	suffered
遭報	avenged
遭受	suffer
適當	suitable
適當	appropriately
適當	appropriate
適用	applies
適合	suit
適合	fits
適合	fit
遠航	journeyed
遠程	remote
遠征	expedition
遙遠	far-off
遙遠	distant
違規	violations
違背	disobeyed
違抗	defy
違反	violation
違反	violating
違反	violates
違反	violated
違反	violate
達貢	Dagon
達昆	Darkon
達太	Thaddaeus
達到	reach
達到	attain
道路	roads
道歉	apologized
道德	moral
道口	crossings
過量	excess
過篩	sifted
過期	expired
過早	prematurely
過戶	deeded
過度	overdo
過度	over
過夜	overnight
過去	past
過冬	winterized
運送	ferrying
運輸	transportation
運輸	transport
運輸	haul
運輸	carriage
運行	runs
運用	using
運河	canals
運河	Canal
運動	sport
運動	movements
運動	movement
運動	motions
運動	campaign
遊覽	tour
遊行	procession
遊行	parading
遊行	parade
遊行	marches
遊行	marched
遊行	march
遊戲	game
遊客	visitors
遊客	traveler
遇難	perished
遇到	meet
遇到	encountered
進行	conduct
進攻	attacking
進展	progressing
進展	progress
進口	imported
進口	import
進入	enters
進入	entering
進入	entered
週年	anniversary
逮捕	arrest
連續	continuous
連發	bursts
連枷	flail
連敗	defeats
連接	connection
連接	attach
連天	groaning
造成	resulting
造成	inflicted
造成	inflict
造成	causing
造成	caused
造型	molding
速度	speed
逛到	wandered
通風	vented
通道	passages
通道	passage
通過	through
通過	passing
通過	passed
通過	pass
通過	by
通緝	wanted
通知	notify
通知	informing
通知	informed
通知	inform
通常	usual
通婚	intermarrying
通婚	intermarry
通婚	intermarried
通姦	adultery
通告	notices
通信	communicating
通信	communicate
這裡	here
這樣	such
這個	this
這些	these
途徑	pathways
途徑	approach
逐漸	gradually
透露	revealed
透視	perspective
逆風	headwinds
逆火	backfire
逆境	adversity
逃離	fleeing
逃離	fled
逃逸	escaping
逃逸	escapes
逃逸	escape
逃跑	flee
逃脫	outrun
逃脫	escaped
逃犯	fugitives
逃亡	fugitive
送葬	mourners
退讓	abandons
退縮	cower
退出	exits
退保	surrenders
退休	retirement
退休	retire
追逐	chases
追踪	tracked
追踪	traced
追求	pursuits
追求	pursuit
追求	pursuing
追求	pursues
追求	pursue
追捧	sought
追捕	hounded
追封	bestowed
追兵	pursuers
迷霧	mists
迷路	strayed
迷藥	drugged
迷戀	crushes
迷惑	deluded
迷惑	confuse
迷住	captivated
迴避	shied
迴避	dodged
迴聲	echoes
迴聲	echo
迴旋	whirls
迫害	persecutors
迫害	persecutions
迫害	persecution
迫害	persecuting
迫害	persecuted
迫害	persecute
迫切	urgently
迫使	forcing
迦特	Gittites
迦特	Gath
迦散	Gazzam
迦拉	Heresh
迦實	Gaash
迦哈	Gahar
迦南	Canaanites
迦南	Canaanite
迦南	Canaan
迦勒	Caleb
迦別	Geber
返回	return
近視	shortsighted
迎接	greet
迎來	ushered
迅速	swift
迅捷	swiftness
迂迴	roundabout
農田	farmland
農民	farmers
農民	farmer
農業	farming
農村	countryside
農場	farms
農場	farm
辱罵	taunting
辯護	defends
辯論	debated
辯論	debate
辯解	justify
辯手	debaters
辮子	braids
辨別	discern
辦法	way
辜負	disappoint
辛辣	acrid
辛苦	exhausting
辛勞	toil
辛勞	pains
轟然	crashing
轉身	turned
轉讓	transfer
轉變	transform
轉變	shifts
轉變	conversion
轉移	transferring
轉移	shift
轉換	converts
轉換	converting
轉換	converted
轉售	resold
轉入	transferred
輻條	spokes
輻射	radiates
輻射	radiance
輸送	conveyed
輸入	enter
輪輞	rims
輪胎	tires
輪緣	rim
輝耀	glistens
輝煌	glorious
輝煌	brilliant
輝光	glow
輕鬆	relaxed
輕輕	lightly
輕視	scornful
輕視	contemptuous
輕蔑	sneering
輕蔑	scorn
輕蔑	contemptuously
輕擦	graze
輔助	assisted
載人	manned
較量	bouts
較重	heavier
較弱	weaker
較小	lesser
軸承	bearing
軟膏	ointment
軟墊	upholstered
軟化	softening
軟化	soften
軍隊	troops
軍隊	forces
軍隊	army
軍隊	armies
軍艦	warships
軍營	barracks
軍團	Legion
軍事	military
軌道	orbits
軌枕	sleeper
車道	lanes
車輪	wheels
車軸	axles
車皮	wagon
車手	riders
車夫	charioteer
車削	turning
躲閃	dodge
身體	body
身體	bodily
身體	bodies
身材	stature
身分	identity
躍遷	hopping
蹺著	dangled
蹲伏	crouch
蹲下	crouches
蹣跚	staggers
蹂躪	ravages
蹂躪	ravaged
蹂躪	downtrodden
蹂躪	devastate
踴躍	enthusiastically
踩著	treading
踩出	trodden
踝骨	anklebones
踐踏	trampled
踐踏	trample
踉蹌	staggering
跳閘	strip
跳過	skips
跳過	skipped
跳躍	skip
跳躍	leaping
跳躍	jumps
跳躍	Jumping
跳蚤	fleas
跳蚤	flea
跳舞	dancing
跳舞	danced
跳水	plunge
跳動	beating
跳下	jumped
路面	pavement
路線	routes
路線	route
路由	routed
路標	signpost
路標	guideposts
路德	Lud
路徑	paths
路徑	path
路口	crossing
跨度	span
跡象	signs
跟隨	follow
跟踪	track
跟踪	trace
距離	distance
距離	apart
跛行	limping
跛行	limp
足夠	sufficient
足夠	enough
趨向	tends
趨向	tend
趕緊	hurries
趕快	haste
越過	crossed
越冬	wintered
超過	surpass
超過	overtake
超過	outweigh
超速	speeding
超車	overtaking
超越	surpassed
超越	overtook
超越	overtakes
超然	aloof
起訴	sues
起訴	prosecute
起草	drafted
起色	improvement
起義	uprising
起義	insurrection
起源	origins
起源	origin
起泡	blister
起司	cheese
起兵	revolted
起伏	heaving
走錯	astray
走道	walkway
走穩	steadied
走廊	walkways
走了	gone
赫然	awesomely
赫梯	Hittite
赦免	pardoned
赦免	pardon
赤腳	barefoot
赤紅	crimson
贖金	ransoms
贖金	ransom
贖罪	atonement
贖罪	atone
贖回	redemption
贖回	redeems
贖回	redeemed
贖回	redeem
贖回	ransomed
贏得	win
贊同	endorsed
贊同	approval
賽跑	running
賽跑	racing
賽跑	raced
賽諾	Sirion
賽斯	Seth
購買	purchased
購買	buys
購買	buying
購買	buy
賭注	stake
賭博	gambled
賬戶	accounts
質量	quality
質疑	questioned
賣淫	prostitution
賣淫	prostituting
賣淫	prostituted
賣家	sellers
賣家	seller
賠償	damages
賠償	amends
賞金	bounty
賓虛	Ben-hur
賓客	guests
賓內	Binnui
賈達	Jada
賈森	Jason
賈敏	Jamin
資金	funds
資源	source
資源	resources
資源	resource
資格	disqualify
賄賂	bribing
賄賂	bribed
賄賂	bribe
貿然	rashly
貿易	trading
貿易	trade
費用	fee
費用	expense
費城	Philadelphia
貸款	loans
貸款	loaned
貸款	loan
貸款	lending
買方	buyer
買家	buyers
貶低	belittle
貴族	nobles
貴族	noblemen
貴族	nobleman
責備	reprove
責備	reproach
責備	rebuking
責任	responsibility
責任	responsibilities
責任	obligated
貪戀	lusted
貪心	greed
貪婪	greedy
貪婪	greedily
貪圖	covet
貨車	wagons
貨物	cargoes
貨物	cargo
貧窮	poverty
貧窮	needy
貧困	impoverished
貧困	destitute
貢獻	dedication
貢獻	contribution
貢獻	contributing
貢獻	contributed
財產	possessions
財物	belongings
財富	wealth
負載	loads
負擔	burdens
負擔	burdening
負擔	burden
負傷	wounded
貝諾	Beno
貝爾	Bel
貝拉	Bera
貝拉	Bela
貝丹	Bedan
豹子	leopards
豬肉	pork
豪門	giants
豪豬	porcupines
豪華	luxury
豪華	luxurious
象牙	tusks
象牙	ivory
象徵	symbolizing
象徵	symbolize
豐產	fruitfulness
豐滿	plump
豐富	richness
豐富	rich
豐富	plenty
豐富	plentiful
豐富	enriched
豐富	enrich
豐富	bountiful
豐富	abundant
豐富	abundance
豎琴	harps
豎琴	harp
豁免	exempted
豁免	exempt
讚賞	appreciated
讚美	praising
讚美	praise
讚揚	commends
讚揚	commended
讓步	concession
變醜	disfigure
變窄	narrowing
變暗	darken
變暖	warming
變態	perverted
變態	perversion
變得	becoming
變形	deformed
變化	changes
變亮	brighten
讀者	reader
讀數	readings
護送	escorted
護送	escort
護航	escorting
護士	nurses
護士	nurse
譴責	denounced
譴責	condemns
譴責	condemning
譴責	condemned
譴責	condemn
議會	councils
警惕	wary
警察	police
警報	alert
警報	alarms
警告	warns
警告	warnings
警告	warning
警告	warned
警告	warn
譙呵	berate
識別	recognizes
證明	proving
證明	proves
證明	proven
證明	prove
證明	proof
證明	demonstrated
證據	evidence
證實	proved
謹防	beware
謹慎	prudent
謹慎	cautious
謬誤	falsehood
謠言	rumor
謝謝	thanks
謝謝	thank
謝斯	Sheth
謙遜	humility
謙虛	modesty
謙虛	modest
謙卑	humbles
謙卑	humble
謎語	riddles
謎語	riddle
謊言	lie
謊言	deceit
謀殺	murders
謀殺	murdering
謀殺	murdered
謀殺	murder
謀殺	killing
諾言	promise
諾布	Nob
諾亞	Noah
諺語	proverbs
諺語	proverbial
諺語	proverb
諳練	versed
諮詢	consulting
諮詢	consulted
論據	argument
論壇	Forum
請願	petition
請講	speaking
請求	requesting
請求	request
請教	consult
請帖	invitation
談論	talk
談判	negotiate
調養	nursed
調解	mediate
調用	invoked
調用	invoke
調用	calling
調焦	focusing
調查	surveyed
調查	survey
調查	investigation
調查	investigated
調查	investigate
調情	flirting
調和	reconciling
調和	reconcile
誹謗	slandering
誹謗	slandered
誹謗	slander
課程	course
誰的	whose
說過	said
說謊	lying
說謊	lied
說話	speaks
說話	speak
說服	persuading
說服	persuade
說服	convince
說明	instructions
說明	illustrates
說明	illustrate
說明	explanations
說明	explanation
說明	explains
說明	explaining
說明	explain
說明	describing
說教	preaching
說情	intercede
說出	utter
誤解	misunderstood
誤解	misunderstandings
誤解	misunderstand
誤殺	manslaughter
誤導	misled
誤導	misleading
誤導	mislead
誤導	misdirected
誡命	commandment
誠摯	sincerely
誠意	sincerity
誠實	honesty
誠實	honest
語音	voice
語錄	sayings
語言	languages
語言	language
誘殺	booby-trap
誘捕	trapping
誘捕	ensnaring
誘捕	ensnare
誘惑	temptations
誘惑	temptation
誘惑	seductively
誘惑	seducing
誘惑	seduced
誘惑	enticement
誘惑	enticed
誘惑	entice
誓言	vows
誓言	vowed
誓言	oath
誓要	vowing
認識	recognizing
認識	recognize
認罪	pleas
認真	earnest
認為	think
認為	regarded
認定	finds
認可	recognized
誇耀	boastfully
詳細	detailed
詳情	detail
該隱	Tubal-cain
該隱	Cain
該死	damned
話題	topic
詭計	trickery
詭計	intrigue
詫異	surprised
詩篇	psalms
詩篇	psalm
詩人	psalmist
詩人	poets
詩人	poet
試驗	trials
試著	tried
試探	Tempter
詢問	inquired
詛咒	damnation
詛咒	curses
詛咒	cursed
詛咒	curse
評論	review
評論	Commentary
評定	assessment
評估	evaluating
評估	evaluate
評估	assessments
評估	assessed
評估	assess
註釋	comments
註冊	registration
註冊	registered
訴訟	proceeding
訴訟	lawsuits
訴訟	lawsuit
訴狀	pleadings
許諾	promises
許諾	promised
許多	much
許多	many
設計	devised
設計	devise
設計	designs
設計	designing
設計	designed
設計	design
設置	settings
設置	setting
設想	conceived
設備	equipment
訪問	visits
訪問	visiting
訪問	visit
訪問	interview
訪問	access
記錄	records
記錄	recording
記錄	recorded
記錄	record
記憶	remembering
記憶	memory
記得	remembers
記得	remembered
記得	remember
訓練	training
訓斥	rebuke
討論	discussions
討論	discussion
討論	discussing
討論	discussed
討論	discuss
討好	fawn
討厭	hate
討厭	disgusting
討厭	detests
討厭	despise
計數	counts
計數	count
計劃	scheduled
計劃	plans
計劃	planned
計劃	plan
訂購	order
訂婚	engagement
訂婚	engaged
言語	speech
觸摸	touches
觸摸	touch
解開	untying
解開	untie
解鎖	unlatch
解釋	interprets
解釋	interpretation
解釋	explained
解讀	interpreting
解讀	interpreted
解讀	interpretations
解決	solve
解決	settling
解決	settle
解決	resolved
解決	resolve
解決	addressed
解析	resolving
解散	disbanded
解凍	thaws
解僱	sack
角落	nook
角落	corners
角色	role
角度	angle
觀點	viewpoint
觀看	watching
觀星	stargazers
觀察	observes
覬覦	coveting
親自	personally
親切	gracious
親切	cordially
視窗	windows
視圖	view
視力	vision
視力	sight
規模	scale
規格	specifications
規定	stipulations
規定	stipulation
規定	specified
規定	provisions
規定	provision
規定	prescribed
規劃	planning
規則	rules
規則	rule
見證	witness
見證	testimony
覆蓋	overlaying
覆蓋	overlay
覆蓋	overlaid
覆蓋	covering
覆蓋	covered
覆上	clothe
要求	requiring
要求	requires
要求	requirements
要求	require
要求	requests
要求	requested
要求	demanded
要求	claim
要么	or
西麥	Simeon
西鹿	Serug
西頓	Sidonians
西頓	Sidon
西訂	Siddim
西蒙	Simon
西蒙	Shimon
西緬	Shimeon
西珥	Seir
西烈	Sered
西流	Seleucia
西沽	Secu
西曷	Shihor
西拉	Sirah
西拉	Serah
西巴	Zebah
西巴	Seba
西宏	Sihon
西南	southwest
西北	northwest
西割	Segub
西列	Seled
襲擊	raiding
襲擊	raid
襲擊	attacked
襯衫	shirts
襯衫	shirt
襯衣	undergarments
襯套	bush
襟翼	flaps
褻瀆	profanity
褻瀆	profaning
褻瀆	profaned
褻瀆	desecration
褻瀆	desecrating
褻瀆	desecrates
褻瀆	desecrated
褻瀆	blasphemies
褻瀆	blasphemes
褻瀆	blasphemed
褻瀆	blaspheme
褶皺	folds
褲子	pants
褪色	faded
褪色	fade
複雜	complicated
複雜	complex
複製	reproduce
複製	copy
複製	copied
複葉	fronds
製造	manufacture
製造	making
製圖	mapping
製品	products
製備	preparation
製作	made
裸露	uncovered
裸露	exposed
裸露	bared
裡特	Riphath
裝飾	trims
裝飾	ornament
裝飾	decorative
裝飾	decoration
裝飾	decorated
裝飾	decorate
裝載	loading
裝設	furnish
裝備	outfitted
裝備	equipped
裝備	equip
裝修	renovation
裝修	furnished
補種	replant
補救	remedy
補品	fortifying
補助	grants
補充	replenish
補償	compensated
補償	compensate
補丁	patches
補丁	patch
裘德	Jude
裂縫	cranny
裂縫	cracks
裂紋	crack
裂口	rips
裂口	cleft
裂口	chasm
裁縫	tailors
裁縫	tailor
裁決	ruling
裁判	magistrates
被騙	tricked
被騙	deceived
被騙	cheated
被迫	forced
被迫	compelled
被砸	smashed
被盜	stolen
被撞	knocked
被搶	robbed
被捕	arrested
被捕	apprehended
被挖	gouged
被困	trapped
被咬	bitten
被告	accused
被刺	stabbed
衷心	wholehearted
衷心	heartfelt
衰退	falter
衰退	fading
衰變	decays
衰變	decay
衰落	decadence
衰竭	exhaustion
衰減	decaying
表面	surface
表達	expression
表達	expressing
表達	expressed
表白	vindication
表白	vindicate
表現	express
表現	behave
表明	indicate
表揚	praises
表彰	honoring
表彰	commendations
表姐	cousin
衣櫃	wardrobe
衣服	clothes
衣夾	peg
衝突	conflict
衝突	clash
衝動	urges
衛士	guards
衛冕	defending
街道	streets
術語	term
行軍	marching
行走	plying
行賄	bribes
行程	stroke
行程	itinerary
行為	deeds
行為	behavior
行為	behaving
行為	acts
行業	industry
行李	baggage
行政	administration
行動	actions
行動	action
行動	acted
行列	ranks
行使	exercised
行使	exercise
血跡	bloodstains
血腥	bloody
血絲	bloodshot
血紅	bloodred
血液	blood
血洗	bloodbath
血污	bloodstained
血塗	blood-smeared
血塊	gore
蠢事	folly
蠟剪	snuffers
蠕蟲	worms
蟲蝕	moth-eaten
蟋蟀	crickets
螺栓	bolts
螺栓	bolt
螞蟻	ants
融化	melting
蝸牛	snails
蝙蝠	bats
蝙蝠	bat
蝗蟲	locusts
蝕刻	etched
蝎子	scorpions
蜥蜴	lizards
蜥蜴	lizard
蜜蜂	bees
蜜糖	honey
蜇傷	stings
蜂窩	honeycomb
蜂擁	swarming
蛋糕	cakes
蛋糕	cake
蚱蜢	grasshoppers
蚱蜢	grasshopper
蚊蚋	gnats
蚊蚋	gnat
號角	bugle
號手	trumpeters
虛線	dashed
虛無	nothingness
虛心	humbly
虛度	desecrate
虛偽	pretense
處罰	punishments
處罰	punished
處罰	penalties
處置	disposal
處理	process
處理	handling
處理	handled
處理	handle
處理	dealt
處決	executions
處女	virgins
處女	virgin
虔敬	reverent
虐待	mistreating
虐待	mistreated
虐待	mistreat
蘋果	apples
蘋果	apple
蘇薩	Susa
蘇爾	Sur
蘆葦	reeds
蘆葦	reed
藥膏	ointments
藥品	medicines
藤蔓	vine
藝術	arts
藍色	blue
藉口	excuses
藉口	excuse
薩萊	Sarai
薩科	Nicolas
薩拜	Zabbai
薩土	Zattu
薛西	Artaxerxes
薄霧	mist
薄情	fickle
薄壁	walled
蕭條	depression
蕁麻	nettles
蔬菜	vegetables
蔬菜	vegetable
蔓生	sprawl
蔓延	sprawling
蔑視	scorned
蔑視	mockery
蔑視	disdainful
蔑視	despising
蔑視	defied
蔑視	defiance
蓮花	lotus
蓬勃	vigorous
蓋子	covers
蒼鷺	herons
蒼蠅	flies
蒼白	pale
蒼涼	desolation
蒸發	evaporates
蒸發	evaporated
蒸汽	steam
蒸氣	vapors
蒲草	bulrushes
蒔蘿	dill
蒐集	glean
蒐集	gathering
蒐集	collect
蒂莫	Timon
葬禮	funerals
葬禮	funeral
葬禮	burial
葫蘆	gourds
董事	directors
葡萄	grapes
葡萄	grape
葛森	Gershon
著火	afire
著名	famous
著名	famed
著名	celebrated
葉片	blades
葉子	foliage
落馬	sacked
落潮	ebb
落水	overboard
落後	trailed
落後	trail
落後	backward
落下	swoop
落下	falling
萬能	all-powerful
萬丈	bottomless
萎縮	shrivel
萎縮	shrank
萎凋	withering
萊赫	Lehi
菲比	Phoebe
菲伊	filly
華麗	gorgeous
華蓋	canopy
華美	colorful
菜單	menu
菖蒲	calamus
莽莽	luxuriant
莫薩	Moza
莎瑪	Shama
莎拉	Sarah
莊嚴	stately
莊嚴	solemn
荒野	wilderness
荒謬	ridiculous
荒誕	absurd
荒蕪	desolated
荒蕪	barren
荒涼	desolate
荒地	wastelands
荒地	wasteland
荊棘	thorns
荊棘	thornbushes
荊棘	briers
荊棘	brambles
荊棘	bramble
草藥	herbs
草草	hastily
草甸	meadows
草案	draft
草寇	bandits
草場	pasturelands
草地	meadow
茅房	latrine
范甯	fanning
英雄	heroes
英雄	hero
英鎊	sterling
英鎊	pounds
英里	miles
英里	mile
英畝	acre
英寸	inches
英寸	inch
英勇	valiant
英勇	heroic
英俊	handsome
苦難	tribulation
苦難	misery
苦難	distress
苦難	afflictions
苦澀	pained
苦澀	anguished
苦澀	agonized
苦惱	troubled
苦惱	distressed
苦味	bitterness
苦修	penance
苛刻	harsh
芽接	budding
芳香	aromatic
花費	spent
花費	expenses
花瓣	petals
花環	garlands
花束	bouquet
花園	gardens
花園	garden
花圈	wreaths
花圈	wreath
花卉	flowers
芯片	chip
芥末	mustard
芊芊	flourishing
艾格	Etam
艾文	Aven
艾拉	Ira
艾因	Ain
艾克	Eker
艾亞	Aija
艷羨	envied
色帶	ribbon
艱辛	hardships
良心	consciences
良心	conscience
艦隊	fleet
艙口	hatches
船頭	prow
船隻	vessels
船隻	vessel
船長	captains
船舶	ships
船殼	hull
船東	shipowners
船員	crews
船員	crew
船上	aboard
舷梯	ramp
舵手	helmsmen
航行	voyages
航行	sailed
舞蹈	dances
舞蹈	dance
舞者	dancers
舞弊	fraud
舞動	galloping
舒適	comforts
舒爾	Shur
舒展	stretches
舍瓦	Sheva
舌頭	tongues
舊的	older
興旺	thrive
興奮	excited
興亞	Koa
致盲	blinding
致命	lethal
致命	fatally
致命	fatal
致命	deadly
自責	self-condemned
自負	conceited
自負	conceit
自豪	pride
自誇	brags
自誇	boasts
自誇	boastful
自行	voluntarily
自給	self-sufficient
自稱	claiming
自私	selfishness
自私	selfish
自由	freedom
自由	free
自爆	blew
自然	naturally
自然	natural
自滿	complacent
自滿	complacency
自殺	suicide
自曝	exposes
自旋	spins
自我	selves
自律	self-discipline
自己	oneself
自如	freely
自在	unrestrained
臨門	Rimmon
臨近	neared
臨死	mortally
臨時	temporary
臥室	bedrooms
臥室	bedroom
臍帶	umbilical
臉頰	cheeks
臉頰	cheek
臉紅	blush
臉盆	washbasin
臂章	armbands
臀部	rump
臀部	hips
臀部	hip
臀部	buttocks
膽怯	timidity
膽小	timid
膽大	bold
膳食	meal
膨化	puffed
膠帶	tape
膠合	glued
膝部	lap
膝蓋	knees
膝蓋	knee
膚色	complexion
腹中	unborn
腸斷	Heartbroken
腸子	bowels
腳鐐	shackled
腳踝	ankles
腳跟	heels
腳跟	heel
腳趾	toes
腳趾	toe
腳氣	Beri
腳步	steps
腳本	scripts
腳本	script
腳印	footprints
腳凳	footstool
腰部	waist
腫脹	swelling
腫瘤	tumors
腐肉	carrion
腐爛	rotting
腐爛	rots
腐爛	rot
腐敗	depravity
腐敗	corrupts
腐敗	corruption
腐敗	corrupting
腐敗	corrupt
腎臟	kidneys
腋窩	armpit
腋下	armpits
脾氣	temper
脫落	shedding
脫粒	threshing
脫粒	threshes
脫粒	threshed
脫粒	thresh
脫加	Dophkah
脖子	necks
脊柱	spine
脆皮	crust
脆弱	frail
脆弱	fragile
脂肪	fat
能量	energies
能源	energy
能夠	can
能夠	able
能力	ability
能力	abilities
胸部	chest
胸甲	chestpiece
胴體	carcass
胡說	babbling
胡說	babbles
胡裡	Huri
胡巴	Huppah
胞衣	afterbirth
胎面	treads
背風	leeward
背部	back
背道	Backsliders
背負	saddled
背負	burdened
背誦	reciting
背誦	recite
背景	background
背後	behind
背帶	Strap
背叛	rebelled
背叛	forsake
背叛	betraying
背叛	betrayed
背叛	betray
胃口	appetites
育肥	fattening
肯定	affirmation
肩膀	shoulders
肩件	shoulder-pieces
肥皂	soap
肥料	fertilizer
肢解	mutilated
股票	stock
肝臟	livers
肚皮	belly
肚子	bellies
肌肉	muscles
肋骨	ribs
肋骨	rib
肉類	meats
肉湯	broth
肉桂	cinnamon
肆虐	rages
肆虐	raged
聽說	heard
聽話	obedient
聽眾	listeners
聽眾	audience
聽取	heeded
聽力	hearing
聽了	listened
職責	duties
聳肩	shrugged
聳立	towered
聲音	voices
聲音	sounds
聲音	sound
聲譽	reputation
聲討	denounce
聲稱	claimed
聲母	initials
聲望	prestige
聲明	statements
聲明	statement
聲明	stated
聲明	pronouncements
聲明	declaring
聲明	declares
聲明	declared
聰明	wiser
聰明	smarter
聰明	smart
聰明	cleverness
聰明	clever
聯邦	federation
聯繫	ties
聯繫	contact
聯盟	union
聯盟	coalition
聯盟	alliances
聯盟	alliance
聯營	associates
聯合	joint
聚會	gatherings
聚斂	amassed
聘請	hire
聖職	priesthood
聖經	Scriptures
聖經	Scripture
聖潔	sanctifying
聖潔	holiness
聖潔	holier
聖歌	hymn
聖人	saints
耶賓	Jabin
耶色	Jezer
耶穌	Jesus
耶疊	Jediael
耶杜	Jeduthun
耶末	Jarmuth
耶拉	Jerahmeel
耶拉	Jerah
耶戶	Jehu
耶利	Jeuel
耶利	Jeiel
耳鳴	tingle
耳語	whispers
耳語	whisperings
耳語	whispering
耳語	whisper
耳環	earrings
耳環	earring
耳朵	ears
耳垂	earlobes
耳垂	earlobe
耳光	slapped
耗盡	depleted
耗材	supplies
耕種	tilled
耕作	plowing
耐力	endurance
考茲	Koz
考慮	considers
考慮	considering
考慮	considered
考慮	consideration
考慮	consider
老鼠	mouse
老饕	gluttons
老闆	boss
老練	seasoned
老張	embittered
老年	elderly
老師	teacher
老將	veteran
老兵	veterans
翼展	wingspan
翻騰	writhes
翻騰	writhe
翻騰	churning
翻閱	thumbing
翻錄	ripping
翻譯	translated
翻滾	tumbles
翻倍	doubled
翱翔	soar
習慣	habit
習慣	custom
翅膀	wings
翅膀	wing
羽毛	plumage
羽毛	feathers
義務	obligations
義務	obligation
義務	duty
羨慕	envy
羨慕	envious
群落	colonies
群眾	masses
羞辱	shaming
羞辱	humiliated
羞辱	humiliate
羞辱	dishonor
羞愧	shamed
羞愧	ashamed
羞怯	coyness
羚羊	gazelle
羚羊	antelopes
羚羊	antelope
羔羊	lambs
美麗	beautiful
美食	delights
美食	delicacies
美白	whitens
美德	virtues
美女	beauty
美化	glorifies
美化	beautify
美元	dollars
羊肉	lamb
羊毛	woolen
羊毛	wool
羊毛	fleece
羊圈	sheepfolds
羊圈	sheepfold
羈絆	fetters
羅馬	Rome
羅馬	Roman
羅達	Rhoda
羅茲	Rhodes
羅米	Shelomi
羅摩	Shelomoth
羅德	Lod
羅密	Shelomith
羅什	Rosh
罷工	strikes
罷工	strike
罰款	penalty
罰款	fined
罪行	offenses
罪行	offense
罪犯	offenders
罪犯	criminals
罪惡	evils
罪孽	iniquity
罪人	sinners
罪人	sinner
罕見	uncommon
罕見	rare
罐頭	preserved
罐子	jars
缺陷	defects
缺陷	defective
缺陷	defect
缺陷	blemish
缺憾	comings
缺席	absent
缺席	absence
缺乏	scarcity
缺乏	lacks
缺乏	lacked
缺乏	lack
纖維	fiber
纖巧	dainty
纏身	ridden
纏綿	lingering
繼續	proceeded
繼續	proceed
繼續	continuing
繼續	continues
繼續	continued
繼續	continue
繼承	inherit
繪製	plotting
繪製	plotted
繪畫	paintings
繩索	ropes
繡花	embroidering
繡花	embroidered
織布	weaving
織工	weavers
繅絲	reeling
繃帶	bandages
繃帶	bandage
繁華	bustling
繁榮	prospers
繁榮	prosperous
繁榮	prosperity
繁榮	prospered
繁榮	prosper
繁榮	flourish
總計	totals
總計	totaled
總結	summed
總結	summarize
總結	concluded
總是	always
總和	sums
縮短	shortens
縮短	shortening
縮短	shortened
縮小	dwindle
縫合	stitched
練級	leveling
緩解	relieving
緩解	relieve
緩解	eased
緩解	ease
緩刑	reprieve
編隊	formation
編譯	compiled
編號	numbering
編號	numbered
編織	woven
編織	weave
編織	braided
緣故	sakes
緞帶	ribbons
緊迫	pressing
緊貼	snugly
緊縮	tightening
緊縮	tighten
緊緊	tightly
緊急	urgent
緊急	crash
緊張	nervously
緊張	nervous
綽號	nicknamed
綻放	blooms
網關	gateways
網關	gateway
網羅	snares
網絡	networks
網絡	network
維持	sustains
維持	maintaining
維修	repairs
綠色	green
綠玉	beryl
綠化	greenery
經驗	experiences
經驗	experience
經理	manager
經濟	financially
經歷	undergo
經歷	experiencing
經期	menstruation
經文	verses
經常	regularly
經常	often
經常	constantly
綁腿	leggings
綁架	kidnaps
綁架	kidnapped
綁匪	kidnapper
絲毫	slightest
統籌	ordination
統治	ruled
統治	reigns
統治	reign
統一	unity
統一	unify
給藥	administering
給予	render
給予	afford
絞殺	strangulation
絞架	gallows
絕望	hopeless
絕望	desperation
絕望	despairs
絕望	despairing
絕望	despair
絕對	absolutely
絕對	absolute
結餘	balances
結論	conclusions
結論	conclusion
結算	settles
結痂	scabs
結構	structures
結果	results
結果	result
結束	ends
結束	ended
結束	end
結巴	stammer
結尾	ending
結婚	marrying
結婚	marry
結婚	marries
結夥	gang
結合	combined
結合	binds
絆腳	stumbling
絆倒	stumble
組裝	assembled
組織	organize
組織	organization
組成	consist
組合	combination
組件	assemblies
終於	eventually
終局	finality
紹阿	Shoa
細胞	cell
細節	details
細心	attentive
紮紮	Zaza
紮營	encampment
紮營	camped
紮實	solidly
紫色	purple
紫晶	amethyst
索賠	claims
索科	Soco
索爾	Saul
紡織	spinning
紛飛	swirling
級聯	cascades
紗布	gauze
純血	pure-blooded
純粹	purely
純度	purity
純化	purification
納摩	Naam
紋身	tattoos
紊亂	disorder
紅酒	wine
紅潤	ruddy
約蘭	Joram
約蘭	Jehosheba
約蘭	Jehoram
約葉	Joed
約翰	John
約珊	Jokshan
約會	appointments
約旦	Jordan
約拿	Jonah
約拿	Jehonathan
約念	Jokneam
約帖	Joktheel
約帕	Joppa
約巴	Jobab
約定	appointment
約亞	Joah
紀念	remembrance
紀念	commemorate
紀律	disciplined
糾集	mustered
系譜	pedigrees
系統	system
系列	series
糧食	grain
糧倉	granaries
糞便	excrement
糕點	pastries
精選	picks
精製	refining
精製	refined
精美	exquisite
精美	beautifully
精細	fine
精神	spiritual
精神	spirit
精確	exact
精液	semen
精明	shrewdest
精明	shrewd
精明	astute
精彩	wonderful
精巧	delicate
粘液	slime
粘土	clay
粗野	insolent
粗心	careless
粗壯	sturdy
粗俗	profane
粉碎	smash
粉碎	pulverize
粉碎	crush
粉末	powder
粉刷	whitewashed
米達	Medad
米設	Meshech
米羅	Millo
米甸	Midianite
米煞	Meshach
米沙	Mesha
米撒	Mizzah
米德	Mede
米店	Midian
米娜	mina
米卡	Micah
米勒	Melech
米利	Miletus
米丁	Middin
籬笆	fence
籠罩	shrouded
籠罩	enveloped
籠罩	blanketed
簾子	hangings
簽約	signing
簡要	brief
簡稱	referred
簡單	simplest
簡單	simple
簡單	easy
簌簌	rustled
篩選	sifting
篝火	bonfire
範圍	scope
範圍	range
範圍	limits
節省	saves
節目	shows
節日	festivals
節日	feasts
節拍	beats
箱子	chests
箭頭	arrows
箭頭	arrowhead
箭頭	arrow
管道	pipes
管理	manages
管理	managed
管理	manage
管理	administer
管教	chastening
管它	cares
算命	fortune-telling
算命	fortune-tellers
策略	strategies
答案	answers
筏子	rafts
等閒	thoughtlessly
等閒	aimlessly
等於	equal
等待	waits
等待	waited
等待	wait
等待	awaiting
等待	await
等候	waiting
筆記	notes
筆直	squarely
第四	fourth
第十	tenth
第六	sixth
第八	eighth
第五	fifth
第二	second
第九	ninth
第三	third
第七	seventh
第一	first
笨拙	clumsy
符號	symbols
符號	symbol
符合	meets
笛手	flutist
笛子	flutes
笑話	jokes
笑聲	laughter
笑笑	smiled
笑柄	laughingstock
笑容	smiles
笑傲	scorning
笑了	laughed
竭誠	wholeheartedly
童貞	virginity
童年	childhood
站立	stands
站在	stood
立拿	Libnah
立尼	Libni
立即	immediately
竊賊	burglar
竊聽	tapped
竊聽	eavesdrop
竊喜	coursing
竄出	sprang
窺視	peep
窺探	spied
窩點	dens
窩藏	harboring
窩棚	Tabernacle
窩棚	shack
窗簾	curtains
窗簾	curtain
窗扇	sashes
窗扇	sash
窗台	windowsill
窗台	ledge
窗口	window
窒息	stifle
突破	topped
突破	exceeded
突破	breached
突發	outburst
突然	suddenly
突然	sudden
突然	abruptly
突擊	assault
突出	prominent
突出	projecting
穿透	penetrate
穿著	wore
穿著	wearing
穿線	stringing
穿梭	shuttle
空間	space
空虛	emptiness
空白	gaps
空洞	hollow
空氣	air
空手	empty-handed
究竟	exactly
穩步	steadily
穩定	steady
穩定	stable
積累	accumulated
積累	accumulate
穀物	grains
穀倉	barns
穀倉	barn
稻草	straw
稱重	weighing
稱重	weighed
稱重	weigh
稱讚	praised
種馬	stallions
種雞	breeders
種植	planting
種族	race
種子	seeds
種子	seed
稠密	dense
程度	extent
程序	program
程序	procedures
程序	procedure
稀缺	scarce
稀有	rarest
移民	migration
移民	immigrants
移植	transplanted
移動	moving
移動	moves
移動	moved
移動	move
移交	handing
秸稈	stalks
租金	rents
租用	leased
租戶	tenants
秘書	secretary
秘書	secretaries
秘密	secrets
秘密	secret
科雷	Kore
科隆	cologne
科學	science
秋季	fall
秋季	autumn
私語	murmur
私自	privately
私章	signet
秀發	tresses
禿鷹	vultures
禿鷹	buzzards
禿鷲	vulture
禱告	prayer
禮貌	courtesy
禮貌	courteously
禮物	presents
禮服	gowns
禮服	dresses
禮堂	auditorium
禮品	gifts
禮品	gift
福音	gospel
福利	well-being
福利	welfare
禍害	scourges
禁食	fasting
禁食	fasted
禁止	prohibit
禁止	forbid
禁止	barred
祭壇	altars
祭司	priestly
票據	bills
神醫	miracle-working
神諭	oracle
神話	myths
神聖	sacred
神聖	divine
神經	nerve
神秘	mystery
神秘	mysterious
神社	shrines
神社	shrine
神奇	miraculous
祝賀	congratulated
祝賀	congratulate
祝福	wishes
祝福	blessings
祝福	blessing
祝福	blesses
祖父	grandfather
祖母	grandmother
祖先	forefathers
祖先	ancestry
祖先	ancestors
祖先	ancestor
祈禱	prays
祈禱	praying
祈禱	prayers
祈禱	prayed
祈禱	pray
社會	society
社區	community
示米	Shimeam
示範	demonstration
示範	demonstrating
示番	Shepham
示撒	Shishak
示押	Sheal
示意	motioned
示劍	Shechemites
示劍	Shechem
礦石	ore
礦渣	slag
礦山	mines
磷火	wildfire
磯法	Cephas
磯倫	Eglon
磨難	tribulations
磨碎	grinding
磨石	millstone
磨盤	millstones
磨光	burnished
磚塊	bricks
磕碰	bump
確認	confirms
確認	confirming
確認	confirmed
確認	confirmation
確認	confirm
確認	affirm
確認	acknowledge
確實	indeed
確定	specifying
確定	identified
確定	determines
確定	determine
確定	define
確保	ensure
碰壁	rebuffed
碧空	cloudless
碧玉	jasper
碗碟	dishes
碗形	bowl-shaped
碎裂	shatters
碎石	gravel
碎布	rags
硬質	flinty
硬度	hardness
硬幣	coins
硬幣	coin
硬化	hardened
硬化	harden
砸死	stoned
破陣	destroys
破解	cracked
破舊	shabby
破舊	broken-down
破碎	crushing
破碎	broken
破爛	tattered
破爛	ragged
破滅	shattered
破曉	dawned
破損	damaged
破壞	undermined
破壞	undermine
破壞	ruining
破壞	disrupt
破壞	destroy
破壞	breaking
研究	studying
研究	study
研究	studied
研磨	grind
砍伐	felled
砂漿	mortar
石頭	stones
石膏	plaster
石榴	pomegranates
石榴	pomegranate
石方	stonework
石匠	stonemasons
矮人	dwarf
短跑	dash
短語	phrase
短視	sighted
短命	short-lived
知道	knows
知道	know
知道	knew
知識	knowledge
矜持	restrained
矛頭	spearhead
矛盾	contradicted
瞼板	Tarsus
瞭望	lookouts
瞬間	moments
瞬間	instant
瞪羚	gazelles
睾丸	testicles
睫毛	lashes
睫毛	lash
睡覺	sleeps
睡覺	sleep
睡衣	nightshirt
睡著	asleep
睡眠	slumber
睡眠	sleeping
睚魯	Jairus
眾生	beings
眾多	numerous
眾人	multitudes
眼睛	eyes
眼看	seeing
眼皮	eyelids
眼淚	tears
眼淚	tear
眼力	eyesight
眼光	insight
眺望	overlooks
眨眼	wink
真誠	sincere
真相	truth
真理	truths
真正	true
真正	genuine
真棒	awesome
真實	truthful
真實	real
看護	nursing
看著	watched
看著	looking
看著	looked
看待	regard
看到	sees
看到	seen
看到	see
眉頭	brow
眉毛	eyebrows
省長	prefects
省級	provincial
盾牌	shields
相關	associated
相當	quite
相當	fairly
相比	compared
相應	corresponding
相對	relatively
相同	same
相同	identical
相反	reverse
相反	contrary
相信	trust
相信	convinced
相信	believing
相信	believes
相信	believed
相信	believe
相似	resembled
相伴	accompanies
相互	mutually
直覺	intuition
直覺	instinct
直行	straight
直立	upright
直的	straightest
直接	direct
直徑	diameter
直到	until
直到	till
盯著	stared
目的	purposes
目的	purpose
目的	object
目標	target
目標	goal
目標	aims
目標	aim
目擊	witnessed
盧斯	Luz
盧克	Luke
盤陀	jagged
盤繞	coiled
盤片	platters
盤曲	twisting
盤旋	circled
盤子	plate
盤問	cross-examine
監視	oversee
監聽	listens
監禁	imprison
監督	supervision
監督	supervising
監督	supervised
監督	supervise
監獄	prisons
監獄	prison
監獄	jail
監控	monitor
監事	supervisors
盟約	covenant
盟國	allies
盟友	ally
盜賊	thieves
盜竊	thefts
盜竊	theft
盛開	bloom
盛行	prevails
盛行	prevailed
盛產	abound
盛況	pomp
盛宴	feast
盛大	grand
盛夏	midsummer
盔甲	armor
盒子	boxes
盎司	ounces
盎司	ounce
益轄	Ibhar
益蘭	Ithran
益拉	Jidlaph
益帖	Jether
盈利	earning
盆地	basins
盆地	basin
皺紋	wrinkle
皺紋	pucker
皺眉	frown
皮革	leather
皮袋	wineskins
皮袋	wineskin
皮膚	skin
皮疹	rash
皮帶	belts
皮包	purses
皇帝	emperor
皇后	queens
百萬	millions
百萬	million
百年	centuries
百合	lily
百合	lilies
百分	percent
白髮	white-haired
白袍	white-robed
白色	white
白痴	idiot
白楊	poplar
白天	daytime
發音	pronouncing
發音	pronounce
發霉	mildewed
發酵	fermented
發達	developed
發送	transmitted
發送	sent
發送	sends
發送	send
發起	initiate
發誓	vow
發誓	swore
發誓	swears
發誓	swear
發話	uttered
發表	published
發行	issued
發芽	sprouting
發芽	sprouted
發芽	sprout
發聲	uttering
發生	occurs
發生	occurred
發生	occur
發生	incurred
發生	happens
發生	happened
發生	happen
發現	found
發現	finding
發現	discovery
發現	discovered
發現	discover
發狂	madly
發燒	fevers
發熱	fever
發洩	vent
發泡	foaming
發放	granting
發放	grant
發揮	unleash
發揮	played
發抖	trembling
發抖	shivered
發抖	shaking
發布	releases
發布	released
發布	release
發布	Publish
發布	posted
發展	growth
發展	develops
發展	developing
發展	develop
發射	transmitting
發呆	trance
發動	waging
發動	waged
發出	sending
登高	ascended
登陸	landed
登基	enthroned
登上	boarded
癲癇	epileptics
癥結	sticking
癒合	heals
癒合	healed
癒合	heal
癌症	cancer
瘢痕	scar
瘟疫	plagues
瘟疫	Pestilence
瘋狂	wildly
瘋狂	madness
瘋狂	furiously
瘋狂	Frantically
瘋狂	crazed
瘋子	Madmen
瘀傷	bruises
痴迷	obsessed
痛飲	carouse
痛苦	sufferings
痛苦	suffering
痛苦	painful
痛苦	miseries
痛苦	anguish
痛苦	agony
痛苦	affliction
痛罵	scolding
痛悔	contrite
痛恨	abhor
痛心	grieves
病床	sickbed
疾飛	darting
疾走	scurry
疾病	sickness
疾病	illness
疾病	diseases
疾病	disease
疼痛	pain
疼痛	aching
疼痛	aches
疼痛	ache
疲勞	weariness
疲勞	wearily
疫情	epidemic
疑惑	doubts
疑問	questioning
疑似	suspect
疏鬆	loose
疏遠	estranged
疏散	scattered
疏忽	oversight
疏割	Succoth
當量	equivalent
當然	sure
當然	certainly
當局	authorities
當家	headed
當下	present
異議	disagreement
異心	unfaithfulness
異心	deceitfulness
異常	unusually
異常	unusual
異常	exceptionally
畫畫	drawing
畝施	Mushi
畏縮	cringed
畏縮	cowering
界限	bounds
男性	males
男孩	boys
男孩	boy
男人	men
甲薛	Kabzeel
甲篾	Kadmiel
甲板	decks
甲板	deck
甩到	flung
用餐	dining
用餐	dine
用心	diligently
用品	articles
用功	Hardworking
用具	utensil
甦醒	awake
產量	yields
產量	yield
產生	yielded
產生	produces
產生	arising
產品	goods
生長	growing
生計	livelihood
生育	childbearing
生的	raw
生病	sick
生病	ill
生病	I'll
生疏	rusty
生產	production
生產	producing
生產	produce
生物	creatures
生物	creature
生活	lives
生活	lived
生活	live
生活	life
生氣	offended
生氣	enraged
生日	birthdays
生日	birthday
生成	produced
生存	survives
生存	survive
甜蜜	sweetly
甜美	luscious
甚至	even
甘露	manna
甘蔗	cane
甘松	nard
甘心	willingly
瓷磚	tiles
瓶子	bottle
瓦礫	rubble
瓦器	Potsherd
環繞	surround
環境	surroundings
環境	circumstance
璧迦	Bilgah
璧該	Bilgai
瑪麗	Mary
瑪鹿	Malluch
瑪頓	Madon
瑪雲	Maon
瑪迦	Maacathite
瑪迦	Maacah
瑪莎	Martha
瑪瑙	carnelian
瑪瑙	agate
瑪斯	Maaz
瑪撒	Massah
瑪拉	Marah
瑪拉	Mahlah
瑪基	Makkedah
瑪坦	Mattan
瑪哈	Mahanaim
瑪吉	Makir
瑪代	Medes
瑪他	Mattaniah
瑟瓦	Sceva
琵琶	lute
理解	understands
理解	understanding
理解	understand
理解	comprehension
理解	comprehend
理由	reasoned
理由	grounds
理想	ideally
理念	idea
球隊	teams
球隊	team
球迷	fans
球探	scouted
現實	reality
現實	realities
現場	site
現場	scene
現在	now
珠寶	jewels
珠子	bead
珍貴	prized
珍貴	precious
珍視	cherish
珍珠	pearls
珍珠	pearl
珍品	treasures
珊迦	Shamgar
珊瑚	coral
珀隆	Pelon
玻璃	glass
玷污	undefiled
玷污	defiling
玷污	defiled
玫瑰	rose
玩笑	joke
王權	royalty
王權	kingship
王朝	dynasty
王座	throne
王子	princes
王子	prince
王國	kingdoms
王國	kingdom
王冠	crown
王侯	princely
玉米	corn
獸類	beasts
獵犬	hound
獵物	prey
獵殺	hunted
獵人	hunters
獵人	hunter
獲救	rescued
獲悉	learns
獲得	obtained
獲得	obtain
獲得	gained
獲得	gain
獲得	acquire
獲勝	victorious
獲刑	jailed
獨身	singleness
獨身	celibate
獨立	independent
獨立	independence
獠牙	fangs
獎章	medallion
獎勵	rewards
獎勵	rewarded
獎勵	reward
獅子	lions
獅子	lion
獄卒	jailer
猶豫	hesitation
猶豫	hesitated
猶太	Judea
猶太	Jewish
猶大	Judeans
猶大	Judas
猶大	Judah
猶八	Jubal
猩紅	scarlet
猥褻	obscenities
猥褻	obscene
猥褻	lewd
猜疑	suspicions
猜測	guess
猛烈	violently
猛攻	onslaught
猛撲	swoops
猛撲	pounce
猛拉	yanked
猖獗	rampant
狹窄	narrow
狩獵	hunts
狩獵	hunting
狡辯	quibble
狡詐	deceitful
狡猾	sly
狡猾	cunning
狡猾	crafty
狠心	heartless
狐狼	jackal
狐狸	foxes
狐狸	fox
狂歡	revelry
狂歡	rave
狂歡	orgies
狂歡	carousing
狂怒	furious
狂奔	bolted
狂人	madman
狀態	status
狀態	states
犯規	fouled
犯規	foul
犯罪	sinning
犯罪	crimes
犯罪	crime
犧牲	sacrificing
犧牲	sacrificial
犧牲	sacrifices
犧牲	sacrificed
犧牲	sacrifice
犁頭	plowshares
牽制	sidetracked
特馬	Tema
特赦	pardons
特羅	Trophimus
特此	hereby
特權	privileged
特權	privilege
特曼	Teman
特徵	features
特庇	Derbe
特定	particular
特定	given
特定	designated
特別	specifically
特別	specially
特別	special
特別	especially
物理	physically
物理	physical
物料	materials
牧民	herdsmen
牧師	priests
牧師	priest
牧師	preacher
牧師	pastors
牧場	pastures
牧場	pastureland
牧場	pasture
牧人	herdsman
牢騷	discontent
牢牢	firmly
牛角	horns
牛肉	beef
牛群	herds
牛油	butter
牛扒	steak
牛奶	milk
牙疼	toothache
片劑	tablet
牆壁	walls
爽快	refreshment
爸爸	Papa
父親	fathers
父親	father
父母	parents
爭辯	contended
爭議	disputes
爭議	disputed
爭議	dispute
爭議	controversy
爭議	controversies
爭議	contentious
爭論	arguing
爭論	argued
爭論	argue
爭搶	jostle
爭奪	scramble
爭奪	grabs
爭吵	strife
爭吵	quarrelsome
爭吵	quarrels
爭吵	quarreling
爬行	creeping
爬行	creep
爬行	crawling
爬行	crawl
爬上	climbed
爪子	paws
爪子	paw
爪哇	Javan
爆裂	burst
爆破	bursting
爆破	blast
爆發	outbursts
爆發	erupted
爆炸	explodes
爆炸	blasts
燧石	flint
燦爛	splendid
營養	nourishment
營養	nourished
營救	rescuing
營地	campsite
營地	camps
燕子	swallows
燒瓶	flask
燒焦	scorch
燒毛	singed
燒壞	burned-out
燒傷	burns
燒傷	burn
燈花	firepans
燈芯	wicks
燈籠	lanterns
燈火	lights
燈檯	lampstands
燈檯	lampstand
燈具	lamps
燈光	lighting
燃燒	burning
熾盛	flaming
熾盛	ablaze
熾熱	red-hot
熾烈	blazing
熱軋	rolled
熱烈	warmly
熱情	zeal
熱情	warmth
熱情	enthusiastic
熱情	enthusiasm
熱忱	zealously
熱心	zealous
熱心	eagerness
熟練	trained
熟練	skillful
熟悉	acquainted
熔體	melts
熔融	molten
熔煉	smelted
熔化	melt
熏黑	blackened
煽動	inciting
煽動	incited
煽動	incite
煮沸	boiled
煩惱	fret
煩亂	upset
照顧	cared
煤煙	soot
煤炭	coal
煙囪	chimney
煉鐵	iron-smelting
然而	yet
然而	however
然後	then
焦點	focus
焦慮	anxiety
無限	unlimited
無關	unrelated
無酵	unleavened
無辜	innocent
無辜	innocence
無路	trackless
無視	ignoring
無處	nowhere
無菌	sterile
無聲	silent
無聲	breathed
無聊	bored
無罪	sinless
無縫	seamless
無窮	endless
無禮	rude
無禮	disrespectfully
無神	godless
無知	ignorance
無眠	sleepless
無疑	definitely
無用	worthless
無用	useless
無用	futility
無用	futile
無法	unable
無法	incapable
無水	waterless
無比	unequaled
無數	uncounted
無數	numberless
無數	myriads
無數	innumerable
無數	countless
無效	nullified
無效	invalid
無意	unintentional
無情	unrelenting
無情	unforgiving
無情	ruthlessly
無情	ruthless
無情	relentlessly
無情	mercilessly
無情	merciless
無形	invisible
無形	formless
無害	harmless
無奈	helplessly
無味	tasteless
無名	nameless
無助	helpless
無力	powerless
無力	inability
無價	priceless
無人	uninhabited
焙燒	roasting
烽火	beacon
烹飪	cooking
烤箱	ovens
烤箱	oven
烘乾	drying
烏鴉	ravens
烏鴉	crows
烏鴉	crow
烏陵	Urim
烏里	Uri
烏西	Uzzi
烏薩	Uzal
烏薛	Uzziel
烏瑪	Ummah
烏爾	Ur
烏泰	Uthai
烏木	ebony
烏斯	Uz
烏撒	Uzzah
烏撒	Uzza
烏拉	Ulla
烏尼	Unni
為聖	Sanctify
災難	catastrophe
災難	calamities
災害	disasters
災害	disaster
災害	calamity
災區	stricken
灼熱	searing
灰色	gray
灰燼	ashes
灰心	discouraged
灰塵	dust
火花	sparks
火花	sparkle
火花	spark
火腿	Ham
火盆	firepot
火燒	flamed
火熱	fiery
火焰	flames
火焰	flame
火焰	blaze
火炬	torches
火炬	torch
火災	fires
火山	volcano
火光	firelight
灑水	watering
灌溉	irrigation
灌溉	irrigate
灌木	shrubs
灌叢	thickets
瀟灑	dashing
瀝青	pitch
瀝青	asphalt
瀑布	waterfall
瀆神	blasphemer
濫用	misuse
濫用	abused
濫用	abuse
濫交	promiscuity
濕透	drenched
濕氣	moisture
濕巾	wipes
激烈	intensely
激烈	intense
激烈	heatedly
激烈	fiercely
激烈	fierce
激流	torrent
激情	passions
激怒	infuriated
激怒	exasperated
激怒	angered
激動	excitement
激動	agitated
澆注	pouring
澆水	watered
潺潺	babble
潰爛	fester
潮汐	tides
潮汐	Tidal
潛行	prowl
潛步	slink
潛伏	lurking
潔茹	Jerusha
潔淨	cleanses
潔淨	cleanse
漫遊	rove
漫遊	roaming
漫遊	roam
漫漫	boundless
漫步	wanders
漫步	wander
漫步	strolling
漫步	stroll
漩渦	swirls
漩渦	swirl
漢娜	Hannah
漠視	disregard
演講	speeches
演講	lecturing
演講	lecture
演習	maneuver
演示	demonstrate
演替	succession
演戲	acting
演出	perform
漂移	drift
漂礫	boulder
漂白	bleached
漂浮	adrift
漂洗	rinsing
漂洗	rinsed
漂亮	pretty
漁獲	catches
漁民	fishermen
滿面	sounded
滿足	satisfy
滿足	satisfies
滿足	fulfills
滿足	contented
滿袋	pocketful
滿腹	bellyful
滿溢	overflowing
滿桶	bucketful
滿意	satisfied
滿意	satisfaction
滿意	pleased
滿意	contentment
滾蛋	Begone
滾滾	billowing
滾滾	billowed
滾動	scroll
滴水	drips
滴水	dripping
滴劑	drops
滲透	permeated
滲透	penetrates
滲血	oozing
滯後	lagging
滔滔	surging
滑輪	sheaves
滑輪	pulley
滑軌	glides
滑車	tackle
滑行	slither
滑行	glide
滑翔	gliding
滑動	sliding
滑倒	slipping
滋養	nourish
滋味	relish
滅絕	exterminated
滅亡	perishing
滂沱	torrential
溺死	drowning
溺愛	spoiling
溶解	dissolve
溫柔	tenderly
溫柔	gentleness
溫暖	warmed
溫度	temperature
溫床	hotbed
溫和	gentle
溢出	spilling
溢出	overflows
溢出	overflowed
溢出	overflow
溝渠	ditches
溝壑	ravines
準確	accurately
準確	accurate
準備	ready
準備	preparing
準備	prepares
準備	prepared
準備	prepare
準備	preparations
準備	poised
源頭	headwaters
湧出	gushed
湧上	swarmed
湖岸	lakeshore
湊近	leaned
渺小	insignificance
游牧	nomadic
游牧	nomad
游泳	swims
游泳	swim
渴望	yearns
渴望	longingly
渴望	longing
渴望	longed
渴望	craves
渴望	craved
渴望	crave
渴慕	thirsts
港口	ports
港口	port
港口	harbors
港口	harbor
測量	measuring
測量	measurements
測量	measurement
測量	measured
測量	measure
測試	tests
測試	testing
測試	tested
測試	test
渠道	channels
渠道	channel
減輕	lightened
減輕	lighten
減緩	slows
減弱	weakened
減少	reduced
減少	reduce
減少	diminished
減少	diminish
減少	decrease
減去	subtract
清零	clears
清除	scavenge
清除	purged
清除	purge
清除	cleared
清醒	sober
清酒	sake
清退	repaying
清算	reckoning
清空	empties
清空	emptied
清爽	refreshing
清潔	purifying
清潔	clean
清洗	cleansed
清單	listing
添加	added
淺灘	shoal
淺灘	shallows
淹沒	submerge
淹沒	overwhelms
混跡	unworthily
混沌	chaos
混合	mix
混合	Blend
混到	mingled
混亂	confusion
深處	depths
深色	dark-colored
深情	affectionately
深度	depth
深刻	profound
淬火	quenched
淬火	quench
淫蕩	lewdness
淫婦	adulteresses
淫亂	promiscuous
淫亂	adulterous
淨化	purify
淨化	purifies
淨化	cleansing
淙淙	murmuring
淑女	lady
淋浴	showering
淋浴	shower
淋水	tricking
涼鞋	sandals
液體	liquids
液體	liquid
液滴	droplets
涓涓	trickling
涉及	relate
涉及	involving
涉及	involves
消除	eliminating
消退	subsided
消費	consuming
消費	consumed
消耗	consumes
消耗	consume
消散	dissipates
消息	messages
消失	vanishing
消失	vanishes
消失	vanished
消失	vanish
消失	disappears
消失	disappearing
消失	disappeared
消失	disappear
浸泡	soaks
浸泡	soaked
海龍	Helon
海鷗	seagull
海關	customs
海軍	navy
海草	seaweed
海綿	sponge
海灘	beach
海濱	seashore
海港	seaport
海洋	oceans
海洋	ocean
海洋	marine
海拔	elevation
海底	seabed
海島	coastlands
海岸	shores
海岸	seashores
海岸	seacoast
海岸	coasts
海域	seas
浮雕	relief
浮躁	impulsive
浮渣	scum
浮渣	dross
浮動	floated
浮動	float
浪費	wasting
浪費	wasted
浪費	waste
浪潮	tide
浪湧	surge
浩蘭	Hauran
流行	popular
流血	bloodshed
流蘇	tassels
流產	miscarried
流產	miscarriages
流產	miscarriage
流浪	strays
流浪	stray
流汗	perspire
流放	banishment
流年	fleeting
流動	flows
流動	flowing
流入	flowed
流便	Reubenites
流亡	exile
派對	partying
派對	party
派對	parties
派出	fielded
活的	living
活動	activity
活動	activities
活力	vitality
活力	vigor
洪水	floodwaters
洪水	floods
洪水	flooding
洪水	flood
洩漏	leaking
洩漏	leak
津貼	allowance
洞穴	caves
洞穴	caverns
洞穴	cave
洗禮	baptisms
洗禮	baptism
洗澡	bathing
洗澡	bathe
洗滌	washing
洗手	hand-washing
洗劑	lotion
洋蔥	onions
泰伯	Tabor
注重	emphasize
注意	notice
注意	note
注意	attention
注定	ordain
注定	doomed
注定	destined
注定	destine
泥坑	wallow
波谷	troughs
波浪	waves
波斯	Persia
波提	Potiphera
波動	swings
泡沫	froth
泡沫	foams
泡沫	foam
泡沫	bubble
泛著	glowing
法院	courts
法路	Pallu
法規	statutes
法規	regulations
法術	spells
法老	pharaoh
法眼	discernment
法案	bill
法案	act
法律	legal
法律	laws
法庭	courtroom
法庭	court
法家	legalists
法官	judges
法官	judge
法勒	Peleg
法利	Pharisees
法令	decrees
法令	decree
泉水	springwater
沿海	coastal
沼澤	swamps
沼澤	swamp
沼澤	marshes
沼澤	marsh
治療	treatments
治療	treatment
治療	treating
治療	treated
治理	governing
治理	governed
治理	govern
治愈	cured
治愈	cure
油煙	fumes
油炸	frying
沸騰	boiling
河馬	hippopotamus
河邊	riverside
河流	rivers
河床	streambeds
河床	riverbed
河岸	riverbank
河伯	Rehoboth
沮喪	downcast
沮喪	dismayed
沮喪	dismay
沙龍	Sharon
沙龍	Shallum
沙麥	Shemer
沙麥	Shammai
沙魯	Salu
沙雅	Hoshaiah
沙賴	Sharai
沙賓	Shaalbim
沙發	couches
沙番	Shaphan
沙瑪	Shammah
沙灘	sands
沙漠	deserts
沙漠	desert
沙洲	sandbars
沙法	Shaphat
沙沙	swish
沙沙	rustle
沙拉	Shelah
沙微	Shaveh
沙基	Shagee
沙列	Sheleph
沖淡	watered-down
沖孔	piercing
沖天	soaring
沖壓	stamped
沒藥	myrrh
沒有	nothing
沒有	none
沒有	no
沒有	haven't
沒有	didn't
沒有	did
沒收	forfeited
沒收	confiscates
沒收	confiscated
沐浴	bathed
沉默	silences
沉默	silenced
沉香	aloes
沉降	settlement
沉迷	indulged
沉船	shipwreck
沉積	deposited
沉睡	slumbering
沉浸	immersed
沉沒	sunk
沉沒	sank
沉思	meditating
沉吟	pondered
汽油	fuel
決心	determined
決定	dictated
決定	decisions
決定	decision
決定	decides
決定	decided
決定	decide
決不	never
污點	tainted
污穢	filthy
污穢	defilement
污水	sewage
污染	polluting
污染	pollutes
污染	polluted
污染	pollute
污染	contamination
污染	contaminated
污染	contaminate
污垢	filth
污垢	dirt
求情	plead
求情	interceded
求婚	courted
汁液	saps
氾濫	overrun
永遠	forevermore
永遠	forever
永恆	eternity
永恆	eternal
永久	permanently
水道	aqueduct
水蛭	leech
水蘇	Stachys
水缸	waterpots
水煙	Shisha
水深	soundings
水泡	blistered
水槽	sink
水槽	cistern
水桶	buckets
水果	fruits
水果	fruit
水晶	crystal
水手	sailors
水手	sailor
水庫	reservoirs
水平	levels
水平	level
水壺	kettles
水壺	kettle
水域	waters
水仙	Narcissus
氣質	qualities
氣旋	cyclone
氣味	smells
氣味	odor
氏族	clans
氏族	clan
毯子	blankets
毛巾	towel
毗珥	Peor
毗力	Pelet
比錄	Beeroth
比述	Abishur
比較	comparing
比較	compare
比賽	races
比賽	match
比裡	Beeri
比色	Bezek
比田	Beten
比拜	Bebai
比拉	Beera
比悉	Bezer
比喻	parables
比勒	Peleth
比加	Pekah
比例	proportion
毒蛇	vipers
毒蛇	viper
毒液	venom
每週	weekly
每當	whenever
每年	yearly
每天	everyday
母鹿	doe
母雞	hen
母豬	sows
母豬	sow
母親	mothers
母親	mother
母羊	ewes
母羊	ewe
母獅	lioness
毆打	beatings
毆打	beaten
毆打	battering
毆打	assaulted
毅力	perseverance
毀容	disfigured
毀壞	devastation
毀壞	destruction
毀傷	mutilate
毀了	ruined
殺死	kills
殺手	slayer
殺害	killed
殲滅	annihilate
殘餘	remnants
殘酷	cruelty
殘酷	cruelly
殘缺	incomplete
殘株	stubble
殘忍	cruel
殊死	desperate
殉國	martyred
死者	departed
死板	rigid
死亡	died
死亡	deaths
死亡	death
歸還	restitution
歸咎	blaming
歷時	lasted
歷史	history
歪曲	distort
歧視	discriminated
武裝	armed
武器	weapons
武器	weapon
武器	arms
步道	trails
步進	stepping
步行	walking
步行	walk
步兵	footmen
步伐	pace
步伐	footsteps
此後	Thereafter
此外	Moreover
此外	furthermore
正義	righteous
正義	justice
正經	decent
正確	properly
正確	proper
正確	correct
正式	officially
正式	formal
正常	normal
正午	midday
歡騰	exult
歡迎	welcoming
歡迎	welcomes
歡迎	welcomed
歡迎	welcome
歡迎	greeting
歡迎	greeted
歡躍	frisk
歡樂	jubilee
歡樂	joys
歡樂	joyous
歡樂	gladness
歡悅	joyously
歡快	merrily
歡喜	rejoices
歡呼	ovation
歡呼	cheered
歡呼	cheer
歐南	Onan
歌楠	Conaniah
歌曲	songs
歌曲	song
歌手	singers
歌手	singer
欽佩	admiration
欺騙	deceiving
欺騙	deceives
欺騙	deceive
欺詐	frauds
欣賞	appreciate
欣賞	admire
欣然	joyfully
欣嫩	Hinnom
欣喜	rejoicing
次要	minor
權重	weights
權威	authority
權力	powers
權利	rights
欄杆	railings
檢索	retrieved
檢測	detect
檢查	inspection
檢查	inspecting
檢查	inspected
檢查	inspect
檢查	examining
檢查	examined
檢查	examine
檢查	examination
檢查	checks
檢查	checking
檢查	checked
檔案	archives
檀香	sandal
橫過	across
橫行	prowled
橫梁	crossbar
橫梁	beamed
橫桿	crossbars
橫幅	banners
橫向	crosswise
橡木	oak
機箱	enclosures
機會	opportunity
機會	opportunities
機會	chances
機會	chance
橄欖	olives
橄欖	olive
樹葉	leaves
樹脂	resinous
樹脂	resin
樹籬	hedge
樹液	sap
樹枝	twigs
樹枝	boughs
樹林	grove
樹木	woods
樹木	trees
樹幹	trunk
樹墩	stump
樵夫	woodcutters
樣本	samples
樣張	proofs
樣式	style
樣品	sample
模糊	obscured
模糊	blurred
模擬	imitate
模式	pattern
模子	mold
模型	model
模具	molds
模仿	imitated
標題	titles
標題	title
標題	heading
標誌	sign
標記	markers
標記	marker
標記	mark
標籤	label
標準	standards
標準	standard
標槍	javelins
標槍	javelin
標榜	flaunted
標本	specimen
樓梯	stairway
樓梯	stairs
樓下	downstairs
樓上	upstairs
樂趣	pleasures
樂趣	pleasure
樂意	gladly
樂意	cheerfully
樂事	lays
樁號	stationing
槳手	oarsmen
構造	construct
構成	posed
構想	conceive
榮譽	honors
榮譽	honor
榮耀	glory
榮耀	glorifying
榮耀	glorify
榮耀	glorified
榮幸	honored
概要	summary
概念	notion
概念	conception
極端	extreme
楓樹	sycamore
楓子	galbanum
楊樹	poplars
楊柳	willows
椽子	rafters
植物	plants
椅子	chair
棺材	coffin
棲息	roosted
棲息	inhabits
森林	forests
森林	forest
棕色	brown
棕櫚	palm
棉被	quilts
棉蘭	Medan
棄兒	outcasts
棄兒	outcast
梭琳	Seorim
梭哥	Socoh
條紋	streaks
條約	treaty
條約	treaties
條目	entry
條款	terms
條件	conditions
條件	condition
梅干	prunes
梅內	Mene
桑拉	Samlah
案件	case
桅杆	masts
桅杆	mast
格格	chattered
格拉	Gera
格子	latticework
根據	depending
根據	according
核心	kernel
核心	core
校驗	verify
校正	corrects
柴堆	woodpile
柱廊	Colonnade
查詢	inquiry
查詢	inquire
染色	staining
染色	stained
染色	dyeing
染料	dyes
染料	dye
柑橘	citrus
某處	somewhere
某物	something
某些	certain
柏油	tar
柏拉	Blastus
架設	erected
枯萎	wither
枯萎	wilts
枯萎	wilted
枯萎	wilt
果醬	preserves
果汁	juice
果園	orchards
果園	orchard
林地	wooded
枕頭	pillow
松樹	pine
東南	southeast
東北	northeast
杯子	cup
束縛	bondage
束帶	belted
杜拉	Dura
村莊	villages
村民	villagers
材料	material
杏仁	almonds
杏仁	almond
朵朵	blossoming
本身	itself
本質	essence
本能	instincts
本能	instinctively
本地	local
本來	originally
末必	Magbish
末位	lowliest
未知	unknown
未定	undecided
未婚	unmarried
未來	future
未來	coming
木炭	charcoal
木桶	cask
木板	planks
木材	timbers
木材	timber
木料	lumber
木工	carpentry
木匠	carpenters
木匠	carpenter
木偶	Asherah
期望	expectations
期望	expectation
期望	expect
期望	desired
期待	expecting
期待	expectantly
期待	expectant
朝聖	pilgrimage
朝天	overturned
朔巴	Shobal
朔吧	Shobab
服裝	garments
服裝	garment
服裝	clothing
服用	taking
服從	submission
服從	obeys
服從	obeying
服從	obedience
服務	serving
服務	services
服務	service
服務	serve
服事	ministering
服事	ministered
朋友	friends
朋友	friend
有頂	roofed
有限	limited
有關	related
有趣	interesting
有色	colored
有罪	sinful
有罪	guilty
有罪	guilt
有用	useful
有理	justified
有毒	poisonous
有時	sometimes
有效	valid
有效	effectively
有效	effective
有性	sexual
有序	ordered
有害	harmful
有害	destructive
有害	damaging
有力	powerfully
有力	forceful
有利	favorably
有利	favorable
有利	beneficial
有人	someone
月經	menstruating
月經	menstrual
月亮	moon
會議	session
會議	meetings
會議	meeting
會議	conference
會談	talks
會話	conversation
會計	accounting
會見	met
會所	clubs
會心	knowing
會堂	synagogue
會員	members
會員	member
最高	tallest
最高	supreme
最高	highest
最遠	farthest
最近	recently
最胖	fattest
最終	ultimately
最窮	poorest
最短	shortest
最熱	hottest
最深	deepest
最早	earliest
最新	latest
最愛	favorites
最後	finally
最後	final
最強	strongest
最弱	weakest
最差	worst
最少	smallest
最小	least
最好	nicest
最好	best
最大	largest
最大	greatest
最佳	top
最低	lowest
替代	substitute
曾經	ever
曾孫	great-grandson
書面	written
書蘭	Meshullam
書念	Shunem
書亞	Shual
書亞	Shuah
曷拉	Hoglah
更高	higher
更難	harder
更遠	farther
更近	nearer
更甜	sweeter
更深	deeper
更正	correction
更新	renews
更新	renewed
更新	renew
更改	change
更換	replacing
更換	replaced
更換	replace
更快	swifter
更快	faster
更差	worse
更好	better
更大	greater
更多	more
曲調	tunes
曲線	curves
曲折	winding
曲折	twists
曝光	exposure
曝光	exposing
暴食	gluttony
暴露	expose
暴雨	rainstorm
暴跌	plunged
暴發	outbreak
暴民	mob
暴政	tyranny
暴君	tyrant
暴君	oppressor
暴動	riots
暴動	riot
暴動	rebellion
暴動	insurrections
暴力	violent
暴力	violence
暫停	paused
暫停	pause
暢快	carefree
暗訪	unannounced
暗算	backstabbing
暗淡	dim
暗洗	Amzi
暗殺	assassination
暗殺	assassinated
暗殺	assassinate
智能	intelligent
智慧	wisdom
智取	outsmart
智勝	outwitted
晶圓	wafers
晶圓	wafer
景點	sights
景觀	landscape
普通	ordinary
普瓦	Puah
普林	purim
普嫩	Punon
普勒	Pul
晦澀	obscurities
晚餐	supper
晚餐	dinner
晚間	evening
晚了	late
晚上	evenings
時間	time
時鐘	clock
時尚	Fashion
時刻	moment
是否	whether
昨天	yesterday
春天	springtime
映射	mapped
星座	constellations
星座	constellation
星光	starlight
易腐	perishable
易於	prone
昏暈	fainting
昏厥	fainted
明顯	obviously
明顯	obvious
明顯	evident
明確	clear
明智	wisely
明智	sensible
明智	sanity
明晰	clarity
明星	stars
明尼	Minni
明天	tomorrow
昆蟲	insects
昂貴	expensive
昂貴	costly
昂然	aflame
早餐	breakfast
早晨	mornings
早上	morning
日誌	logs
日誌	log
日落	sunset
日落	sundown
日期	dates
日期	date
日曬	sunbaked
日曆	calendar
日後	someday
日常	daily
日出	sunrise
既定	established
旗桿	flagpole
旗幟	banner
旋風	whirlwinds
旋風	whirlwind
旋轉	whirling
旋律	melody
旋律	melodies
旅行	trips
旅行	travels
旅行	traveling
旅行	traveled
旅行	travel
旅程	journeys
旅程	journey
旅店	inn
旅客	travelers
施韋	Ishvi
施行	performs
施洗	baptizing
施洗	baptizes
施法	Ashvath
施工	construction
方言	dialect
方舟	ark
方法	ways
方法	methods
方法	approaches
方案	schemes
方案	scheme
方式	manner
方向	directions
方向	direction
方便	convenient
斷裂	fracture
斷絕	sever
斷然	flatly
斷奶	weaned
新鮮	freshly
新鮮	fresh
新郎	grooms
新郎	bridegrooms
新郎	bridegroom
新聞	news
新羅	Silla
新生	rebirth
新生	newborn
新月	new-moon
新月	crescents
新月	crescent
新娘	brides
新娘	bride
新娘	bridal
新奇	newness
斯利	Esli
斬首	beheaded
斬波	chopping
斧頭	ax
斥責	rebukes
斥責	rebuked
斜靠	leans
斜背	slung
斜倚	reclining
斗篷	cloaks
斑點	spots
斑點	speckled
斑點	speck
斑點	blot
斑鳩	turtledoves
斑鳩	turtledove
斑岩	porphyry
文章	writings
文章	article
文明	civilization
文學	literature
文士	scribes
文化	cultures
文化	culture
文件	papers
文件	file
文件	document
數量	quantity
數量	quantities
數數	counting
數字	numbers
數字	figure
數千	thousands
敷料	dressing
敵意	hostility
敵對	hostile
敵人	foes
敵人	foe
敵人	enemy
敵人	enemies
整理	arranging
整理	arranges
整個	whole
整個	entire
敲門	knocks
敲門	knocking
敲詐	extortion
敲定	hammered
敬虔	godly
敬禮	saluted
敦促	urged
敦促	urge
散落	littered
散漫	undisciplined
散步	walks
散射	scatters
散射	scattering
教訓	lessons
教育	educate
教義	doctrine
教派	sect
教會	church
教師	teachers
教導	teachings
教學	teaching
教堂	churches
敘加	Sychar
敘事	recount
救援	rescues
救恩	salvation
救出	deliverance
救主	savior
敏感	sensitive
效益	benefit
效用	effectiveness
效果	effects
故障	faults
故障	fault
故障	failures
故意	willfully
故意	deliberately
故事	tales
故事	story
故事	stories
政治	political
政府	governments
政府	government
放鬆	relax
放電	discharges
放逐	exiling
放逐	exiled
放逐	banishing
放逐	banished
放逐	banish
放蕩	immorality
放置	placed
放縱	indulges
放縱	indulge
放牧	herd
放牧	grazing
放棄	renounces
放棄	renounced
放棄	quit
放棄	abandoning
放棄	abandon
放心	reassured
放大	magnified
放大	enlarged
放大	enlarge
攻略	raiders
攻擊	attacks
攻擊	attack
改革	reforms
改造	transformed
改變	changing
改變	altered
改裝	remodel
改名	renamed
收集	gleaned
收集	gather
收費	charges
收費	charge
收縮	shrinks
收縮	shrink
收緊	tightens
收緊	tightened
收窄	narrowed
收穫	harvesting
收穫	harvested
收益	proceeds
收益	gains
收益	earnings
收成	harvests
收成	harvest
收復	recaptured
收回	withdraw
收割	reap
收到	receives
收到	received
收入	revenue
收入	income
支配	dominate
支柱	pillars
支柱	pillar
支撐	strut
支撐	shore
支撐	braced
支撐	Brace
支持	sustain
支持	supports
支持	supporting
支持	support
支持	buttress
支付	pays
支付	payments
支付	paid
攪拌	stirring
攪拌	stir
攪動	stirred
攪乳	churns
攤子	stall
攤位	stalls
攜帶	carrying
攜帶	carry
攜帶	carries
攀附	clings
攀登	climbing
擺著	arrayed
擺脫	rid
擺盪	swinging
擴張	outspread
擴展	extends
擴展	extending
擴展	extended
擴大	expanding
擴大	expand
擱淺	stranded
擱淺	aground
擰幹	wrung
擦除	erased
擦拭	wipe
擦傷	grazes
擠壓	squeezed
據點	strongholds
據點	stronghold
擔心	worry
擔心	worried
擔心	fearing
擔保	guarantees
擊敗	defeating
擊敗	defeat
擊敗	beat
擊中	hit
擅自	unauthorized
擁有	possesses
擁有	possessed
擁有	owns
擁有	own
擁有	boasting
擁擠	crowding
擁抱	embracing
擁抱	embraces
擁抱	embraced
擁抱	embrace
擁抱	cuddled
撻買	Talmai
撲滅	extinguish
撲來	lunged
播種	sowing
播放	plays
播放	playing
撫育	tending
撫摸	fondled
撥款	allotments
撥弦	plucked
撤銷	revoked
撤退	retreating
撤退	retreated
撤退	retreat
撤消	undoing
撤回	withdrew
撕開	ripped
撕裂	torn
撕裂	tearing
撕毀	tore
撒督	Zadok
撒滿	strewn
撒摩	Zalmonah
撒拔	Zabad
撒拉	Shealtiel
撒慕	Zalmunna
撒南	Zaanan
撒刻	Zaccur
撒分	Zaphon
撒但	Satan
撐著	propped
撇清	whitewash
撇去	skim
撇下	forsaking
摺頁	folding
摸索	grope
摩西	Moses
摩洛	Molech
摩押	Moabites
摩押	Moabite
摩押	Moab
摩尼	Kadmonites
摩利	Molid
摔破	smashes
搶走	snatched
搶購	snapped
搶斷	steals
搶奪	snatch
搶占	seize
搶劫	robbery
搶劫	marauding
搶劫	looting
搶劫	loot
搭成	barricaded
搭售	tying
搬遷	relocated
搞亂	snarl
搜身	frisking
搜羅	scoured
搜索	searching
搜索	searches
搜索	searched
搜索	search
搜查	raided
搜刮	plundered
搗爛	pounded
搖曳	swaying
搔抓	scratching
搏鬥	wrestled
損失	losses
損壞	corrupted
損傷	injure
損傷	damage
援助	aid
揮霍	squandered
揮霍	squander
揮舞	brandished
揮舞	brandish
揮手	waving
揮動	swung
揭露	uncover
揭示	uncovers
揭示	reveals
揭示	revealing
揭示	reveal
揪著	tugging
握緊	clenches
握緊	clenched
換人	substitutions
插手	meddling
插座	sockets
插座	socket
插圖	illustrations
插圖	illustration
插圖	illustrated
插入	inserted
提高	raising
提高	raise
提高	improve
提高	enhances
提高	enhance
提阿	Theophilus
提醒	reminding
提醒	reminders
提醒	reminder
提醒	reminded
提醒	remind
提神	stimulates
提示	tips
提示	suggests
提示	suggestive
提示	suggesting
提示	prompts
提示	prompt
提煉	refines
提煉	refine
提楠	Ithnan
提案	proposal
提拔	promoted
提拉	Tiras
提拉	Shuthelah
提幔	Temanites
提幔	Temanite
提名	nominated
提前	advance
提到	mentioned
提到	mention
提利	Tiria
提列	Teresh
提出	propose
提供	providing
提供	provides
提供	provided
提供	provide
提供	offered
提供	offer
提供	delivers
提交	submitted
提交	submit
提交	filed
提交	committing
提交	committed
提交	commits
描述	description
描述	described
描述	describe
措施	measures
掩蓋	overshadow
掩埋	unburied
掩埋	burying
推薦	recommend
推翻	overthrows
推翻	overthrown
推翻	overthrow
推翻	overthrew
推理	reasoning
推測	speculation
推動	pushing
推動	impelled
推力	thrusts
推力	thrust
推出	launched
控方	prosecuting
控制	controls
控制	controlling
控制	control
接近	nearing
接近	closer
接近	approaching
接近	approached
接觸	touching
接縫	seams
接枝	graft
接收	receiving
接收	receive
接吻	kissing
接受	accepts
接受	acceptable
接受	accept
探險	expeditions
探討	explored
探索	exploring
探索	explore
探班	goings
探測	probe
探寶	revealer
採集	collection
採購	purchase
採訪	interviewed
採用	adopting
採用	adopted
採用	adopt
採摘	pluck
採取	taken
採取	take
採取	resort
掠過	flit
掠奪	raven
掠奪	plundering
掠奪	plunder
掛鉤	hooks
掛起	hangs
掙扎	struggled
排除	excluding
排除	excluded
排水	draining
排水	drain
排氣	exhaust
排放	emission
排扣	breasted
排序	sorts
排序	ordering
排列	array
掐絲	filigree
掐滅	snuffed
掌握	mastered
掉價	plunges
授權	empowering
授權	empowered
授權	empower
授權	authorizing
授予	conferred
授予	confer
掃描	sweeps
掃帚	broom
捷徑	shortcut
捲軸	reels
捲軸	reel
捲取	coiling
捕獲	capturing
捕獲	captures
捕獲	captured
捕獲	capture
捐贈	donating
捐贈	donated
捐款	donations
捐款	donation
捐款	contributions
捆綁	bundles
捆綁	bundled
捆綁	binding
捆綁	bind
挺著	bulging
振臂	rallying
振奮	rouses
挫敗	frustrates
挫折	frustration
挫傷	bruise
挪迦	Nogah
挪巴	Nobah
挪亞	Noadiah
挪亞	Manoah
挨餓	starving
挖空	hollowed
挖掘	digging
挖出	scooped
挖出	gouge
挑選	handpicked
挑染	streaked
挑戰	challenged
挑戰	challenge
按鍵	keys
按說	supposedly
按照	accordance
按扣	snaps
指點	pointing
指責	blamed
指責	accusing
指責	accuses
指責	accusations
指示	instructs
指示	instructing
指示	instructed
指示	indicated
指甲	fingernails
指揮	commanded
指控	accusation
指導	instruct
指導	guidance
指導	directs
指定	designating
指定	designate
指南	guide
指令	instruction
持續	sustained
持續	lasts
持續	last
持續	continual
持有	holds
持久	lasting
持久	enduring
拿鶴	Nahor
拿順	Nahshon
拿轄	Nahash
拿答	Nadab
拿瑪	Naamah
拿拉	Naarah
拿哈	Nahath
拿八	Nabal
拿伯	Naboth
拼寫	spelt
拼寫	spell
拼命	desperately
拷打	torture
拴住	hitch
拳頭	fists
拳頭	fist
拱頂	vault
拱手	submissively
拯救	rescue
拯救	deliverer
拜倒	grovel
招致	incur
招聘	recruitment
招聘	hiring
招牌	signboard
招引	luring
招募	enlist
拖曳	towed
拖拉	hauled
拖延	dragging
拖動	drags
拖動	drag
拔高	overstating
拒絕	rejects
拒絕	rejection
拒絕	rejecting
拒絕	rejected
拒絕	reject
拒絕	refuses
拒絕	refused
拒絕	refusal
拒絕	deny
拒不	refusing
拐杖	crutches
拐杖	crutch
拍賣	sale
拍擊	slap
拍打	slaps
拍打	flap
拍手	clapped
拋出	thrown
拉麥	Lamech
拉薩	Lasha
拉直	straightens
拉瑪	Ramah
拉瑪	Raamah
拉琴	lyres
拉班	Laban
拉法	Rapha
拉比	Rabbi
拉末	Ramoth
拉昆	Rakkon
拉巴	Rabbah
拉客	soliciting
拉吳	Reu
拉含	Raham
拉吉	Lachish
拉億	Laish
拉伸	stretching
拉伸	stretched
拉丹	Ladan
拉丁	Latin
拇指	thumb
拆除	dismantle
拆除	demolished
拆除	demolish
拆分	splits
拂曉	daybreak
拂曉	dawning
抽煙	smoking
抽煙	smoke
抽泣	sobbing
抽搐	convulsions
抽搐	convulsion
押頓	Abdon
押撒	Acsah
抹灰	plastering
抹布	rag
抹去	erase
抹利	Mahli
抵押	mortgaged
抵押	collateral
抵制	resisting
抵債	foreclosed
抱歉	sorry
抱怨	complaint
抱怨	complainers
抱怨	complained
抱怨	complain
抱定	clung
披風	cloak
披肩	shawls
披肩	capes
抨擊	slammed
抨擊	lashed
折騰	tossing
折騰	toss
折邊	hems
折磨	tortured
折磨	torments
折磨	tormentors
折磨	tormenting
折磨	tormented
折磨	torment
折磨	racked
折磨	afflicted
折磨	afflict
折疊	folded
抗議	protested
抗議	protest
投降	surrendered
投降	surrender
投資	investments
投資	invest
投訴	complaints
投票	vote
投標	tender
投標	bidding
投擲	throwing
投擲	hurls
投擲	hurled
投手	pitchers
投手	pitcher
抓起	grabbed
抓住	seizing
抓住	seizes
抓住	gripped
抓住	caught
抓住	catch
抑制	restrain
抑制	curb
把握	grasp
技術	techniques
技能	skills
技能	skill
技巧	tricks
技工	tradesmen
承載	bearers
承諾	pledged
承諾	commitments
承諾	commitment
承諾	commit
承認	recognition
承認	pleaded
承認	confess
承認	concede
承認	admitting
承認	admitted
承認	admit
承認	acknowledges
承認	acknowledged
承擔	undertake
批量	lot
批量	batch
批評	criticizing
批評	criticized
批評	criticize
批評	criticisms
批評	criticism
批准	ratified
批准	approves
批准	approved
批准	approve
扶正	righted
扶手	armrests
扭曲	warped
扭曲	twisted
扭曲	distorted
扭動	writhing
扣留	withheld
扣壓	withhold
托盤	tray
托拉	Tola
打開	opens
打開	opened
打開	open
打算	intends
打算	intending
打算	intend
打碎	shatter
打破	broke
打破	break
打獵	hunt
打架	fights
打敗	defeated
打擾	disturb
打擊	blows
打擊	blow
打扮	groomed
打包	packed
打傷	mauled
打傷	maul
扎眼	garish
手鼓	tambourines
手鼓	tambourine
手鐲	bracelets
手錶	watches
手術	operation
手藝	craftsmanship
手藝	craft
手腕	wrists
手稿	manuscripts
手段	means
手提	portable
手掌	palms
手指	fingers
手指	finger
手帕	handkerchiefs
手工	handiwork
手寫	handwriting
手套	gloves
手勢	gestures
手勢	gesture
扁豆	lentils
扁豆	lentil
所謂	so-called
所有	all
所屬	pertains
所以	so
所以	Consequently
房頂	housetops
房間	room
房屋	houses
房屋	buildings
房地	premises
房主	homeowner
戶篩	Hushai
戶珊	Husham
戶伸	Hushim
戶;	Ashhur
戴勝	hoopoe
戰鬥	fought
戰鬥	fighting
戰鬥	combat
戰鬥	battles
戰鬥	battle
戰馬	warhorses
戰馬	warhorse
戰馬	steeds
戰車	chariots
戰車	charioteers
戰線	fronts
戰爭	wars
戰爭	war
戰斧	battle-ax
戰士	warrior
戰場	battleground
戰場	battlefield
戰勝	prevail
戰功	exploits
或者	possibly
戒菸	quitting
戒指	rings
戒律	commandments
我的	my
我們	we
我們	us
成長	grows
成長	grew
成聖	sanctified
成群	swarms
成群	hordes
成群	flocks
成立	founded
成熟	ripening
成熟	ripe
成熟	mature
成為	become
成為	became
成本	costs
成本	cost
成形	shaped
成就	achievements
成型	shaping
成型	molded
成型	forming
成功	successful
成功	success
成功	succeeded
成功	succeed
戈申	Goshen
戈爾	gores
戈印	Amraphel
懾於	awed
懺悔	confessing
懸空	dangling
懸掛	hoisted
懸念	suspense
懸崖	cliffs
懸崖	cliff
懸垂	overhanging
懸停	hovers
懷疑	suspicion
懷疑	doubted
懷疑	doubt
懷疑	distrust
懷疑	discredit
懷疑	disbelief
懷孕	pregnancy
懶惰	idleness
懲辦	punishes
懲罰	punishment
懲罰	punishing
懲治	punish
懲戒	reprimand
懦夫	cowards
應變	strain
應該	supposed
應該	should
應該	ought
應用	apply
應有	due
應徵	recruited
應得	well-earned
應得	deserved
應對	react
懇求	pleads
懇求	pleading
懇求	plea
懇求	implore
懇求	entreat
懂行	knowledgeable
憤慨	indignation
憤恨	resent
憤怒	wrath
憤怒	raging
憤怒	rage
憤怒	indignant
憤怒	fury
憤怒	angry
憤怒	angrier
憤怒	anger
憐憫	Ruth
憐憫	mercy
憐憫	mercies
憎惡	abhorred
憎恨	detest
憂鬱	sullen
憂傷	sorrowing
慾望	desires
慾望	desire
慷慨	generously
慷慨	generous
慷慨	generosity
慶祝	celebrating
慶祝	celebrates
慶祝	celebrate
慶典	celebration
慣於	won't
慘重	grievous
慘重	disastrous
慎重	discretion
慎重	discreet
慌忙	hurried
態度	attitudes
態度	attitude
感謝	thankful
感謝	thanked
感謝	gratitude
感覺	feels
感覺	feeling
感覺	feel
感知	perceived
感知	perceive
感激	grateful
感染	infection
感染	infected
感染	infect
感應	sensed
感情	affections
感情	affection
感恩	thanksgiving
感恩	thankfulness
感官	senses
感嘆	Laments
感嘆	lamented
感動	touched
愛撫	fondling
愛撫	caresses
愛撫	caressed
愛心	loving
愛心	caring
愚蠢	silly
愚蠢	foolishness
愚昧	ignorant
愚弄	derision
意識	awareness
意見	opinions
意見	opinion
意見	observation
意義	significance
意思	mean
意外	unexpected
意圖	intentions
意圖	intent
意向	intention
愉快	pleasing
愉快	pleasantly
愉快	pleasant
愉快	delightful
愁雲	gloom
惹惱	annoys
想通	figured
想像	imagining
想像	imagined
想像	imagine
想像	imaginations
想像	imaginable
惡魔	demons
惡魔	demon
惡言	blaspheming
惡行	wrongdoings
惡臭	stench
惡毒	viciously
惡毒	vicious
惡毒	malicious
惡毒	evil-minded
惡棍	scoundrel
惡意	maliciously
惡性	malignant
惡夢	nightmare
惡劣	vile
惡人	ungodly
惠理	Eri
情緒	morale
情節	plot
情況	situation
情況	circumstances
情懷	feelings
情慾	lusts
情慾	lust
情感	emotion
情婦	mistresses
情婦	mistress
情報	intelligence
情侶	lovers
情人	lover
悶燒	smoldering
悶燃	smolders
悲慘	tragic
悲哀	sorrow
悲哀	mournful
悲劇	tragedy
悲傷	sorrows
悲傷	grieving
患者	sufferers
患者	patient
患有	suffers
悠揚	melodious
悖離	disobeys
悔改	repents
悔改	repentance
悔改	repent
悔恨	remorse
悄悄	quietly
息怒	pacified
恩膏	anointing
恩安	Enan
恩多	Endor
恩典	grace
恥辱	shame
恥辱	disgrace
恢復	restoring
恢復	restores
恢復	restored
恢復	restore
恢復	restoration
恢復	reinstate
恢復	regain
恢復	recovered
恢復	recover
恐懼	fears
恐懼	fear
恐懼	dread
恐慌	panic
恐怖	terrors
恐怖	terror
恐怖	horrors
恐怖	horror
恐嚇	terrorized
怪物	monster
怨恨	resentment
怨恨	grudge
性質	nature
性急	hotheads
性別	sex
急速	rapidly
急轉	swerved
急躁	irritable
急於	eager
怠惰	laziness
思路	ideas
思考	ponder
思維	thinking
思想	thought
思念	thoughts
怒吼	roars
怒吼	roared
怒吼	roar
忽視	overlooked
忽視	ignored
忽視	ignore
忽視	Disregarding
忽視	disregarded
忽略	neglect
忽略	ignores
快速	fast
快活	merry
快樂	joyful
快樂	happy
快樂	cheerful
忠誠	loyalty
忠誠	loyalties
忠誠	loyal
忠誠	faithfulness
忠誠	devotion
忠誠	devoted
忠誠	allegiance
忠實	faithfully
忠告	advice
忠信	unfaithfully
忙著	busily
忘記	forgot
忘記	Forgetting
忘記	forgets
忘記	forget
志向	ambition
忍耐	patience
忍受	endured
忍受	endure
必須	must
必要	necessary
必然	inevitable
必將	inevitably
心軟	tenderhearted
心軟	relented
心計	scheming
心神	mind
心硬	hard-hearted
心愛	beloved
心中	hearts
徹底	thorough
德魯	drew
德摩	Tadmor
德丹	Dedan
徵稅	tax-collecting
徵用	requisition
徵用	confiscation
徵收	levied
徵收	imposed
徵召	conscripted
徵募	conscript
微風	breeze
微薄	pittance
微笑	smile
微弱	feeble
循環	loops
循環	circulating
復興	reviving
復興	revives
復興	renewal
復甦	recovery
復甦	recovers
復活	revived
復活	revive
復活	resurrection
復活	resurrected
復原	healing
復仇	vengeful
復仇	vengeance
復仇	revenge
復仇	avenges
從而	thus
從而	thereby
從事	engage
徘徊	hovering
徘徊	hovered
徘徊	hover
得罪	offend
得罪	displease
得緊	borne
得撒	Tirzah
得到	gotten
得到	got
得到	getting
得到	gets
得到	get
得來	Edrei
徒然	vain
徒刑	imprisonment
後裔	descendant
後者	latter
後盾	backing
後果	consequences
後悔	repented
後悔	regret
後天	acquired
後來	later
後人	descendants
律師	lawyer
律師	attorney
很快	quickly
很少	seldom
很少	rarely
很好	nicely
待用	inactive
待客	hospitality
征服	vanquished
征服	subdue
征服	conquests
征服	conquest
征服	conquering
征服	conquered
征服	conquer
往往	tended
彼得	Peter
影響	influenced
影響	influence
影響	effect
影響	affects
影響	affect
彩虹	rainbow
彩南	Cainan
形狀	shapes
形狀	shape
形成	formed
形成	form
形式	forms
彎身	stoops
彎腰	Stooping
彎曲	curved
彎曲	bent
彎曲	bends
彎曲	bend
彈簧	springs
彈簧	spring
彈弓	slingshot
彈幕	barrage
強調	stress
強調	highlights
強硬	tough
強盜	robber
強盜	plunderers
強度	strength
強姦	raping
強姦	rapes
強姦	raped
強姦	rape
強奪	ravish
強大	strong
強大	powerful
強化	strengthening
強化	fortify
強化	fortified
強加	impose
張開	gaping
張明	Jadon
張奕	Heman
張大	wide-open
弱點	weaknesses
弱點	weakness
弱者	weaklings
弱小	puny
弱勢	vulnerable
弟子	disciples
弟子	disciple
弗得	ephod
引起	arousing
引起	aroused
引起	arouse
引誘	lured
引線	leads
引發	sparked
引用	recited
引用	quoting
引用	quote
引導	guided
弓步	lunge
弓弦	bowstrings
弄髒	stain
弄髒	muddying
弄直	straighten
弄皺	crumple
弄平	flatten
建造	building
建議	suggestions
建議	suggestion
建議	suggested
建議	suggest
建議	recommendation
建議	proposed
建議	advised
建設	constructing
建立	establishing
建立	establishes
建立	establish
建立	builds
建立	build
延長	prolong
延長	lengthens
延遲	delays
延遲	delayed
延遲	delay
延伸	extend
廣闊	broad
廣泛	widely
廣泛	extensively
廣泛	extensive
廣播	broadcast
廣廈	mansions
廣大	vast
廣場	squares
廣場	square
廣場	plazas
廣告	commercial
廢黜	deposed
廢除	abolish
廢話	nonsense
廢物	wastes
廢止	nullify
廢墟	shambles
廢墟	ruins
廢墟	ruin
廢墟	debris
廚房	kitchens
廚師	cook
廉正	integrity
廁所	toilet
庸俗	vulgar
庸俗	Philistine
庭院	courtyards
庭院	courtyard
庫存	stocked
庫存	inventory
座位	seat
度瑪	Dumah
度外	givers
店主	innkeeper
底部	bottom
底璧	Debir
底本	Dibon
底層	underlying
序列	sequence
床頭	bedside
床罩	comforters
床罩	bedspreads
床單	sheets
床單	linens
庇護	shelter
幾乎	practically
幾乎	nearly
幾乎	almost
幽思	meditate
幼苗	seedling
幼稚	naive
幼稚	childish
幼獸	cub
幼崽	cubs
幻覺	hallucinations
幻滅	disillusionment
幻想	fancy
幸運	fortune
幸運	fortunate
幸福	happiness
幸福	happier
幸福	blessed
年齡	ages
年齡	age
年輕	young
年份	years
平面	plane
平面	flat
平靜	calmed
平衡	poise
平衡	balance
平緩	gently
平等	equality
平滑	smoother
平滑	smoothed
平淡	dull
平時	Usually
平息	stilled
平台	platform
平反	vindicated
平原	plains
干預	intervened
干擾	interfering
干擾	interfered
干擾	interfere
幫腔	chimed
幫手	helper
幫助	helps
幫助	helping
幫助	helped
幫助	assistance
幔利	Mamre
常駐	permanent
常設	standing
帶電	charged
帶狀	banded
帶子	strips
帶刺	barbed
帶來	brings
帶來	bring
帳篷	tents
帳篷	tent
帳戶	account
師妹	Shimei
帝國	Imperial
帝國	empires
帝國	empire
帖子	posts
帖人	Ithrites
帕提	Palti
希連	Helem
希蘭	Huram
希蘭	Helam
希臘	Greece
希洛	Shiloh
希未	Hivites
希未	Hivite
希望	wishing
希望	wished
希望	wish
希望	wants
希望	wanting
希望	hoping
希望	hopes
希望	hoped
希望	hope
希望	desiring
希拉	Helah
希悉	Hezir
希律	Herod
希弗	Hepherites
希弗	Hepher
希勒	Hilkiah
希勒	Helek
希伯	Heber
希伯	Eber
帆船	sailing
帆船	sailboats
布紋	wove
布濟	Buzi
布斯	Buz
布尼	Bunni
布基	Bukki
市長	mayor
市場	mart
市場	markets
市場	market
市井	marketplace
巷道	roadway
巴錄	Parosh
巴蘭	Paran
巴蘭	Balaam
巴結	fawned
巴米	Parmenas
巴瑪	Oholibamah
巴沙	Baasha
巴柯	Barkos
巴末	Bamoth
巴旦	Paddan
巴拿	Baanah
巴拿	Baana
巴拉	Parah
巴拉	Baalath
巴拉	Baalah
巴山	Bashan
巴尼	Shebaniah
巴尼	Bani
巴勒	Balak
巴力	Baal
已經	ve
已經	already
已知	known
已婚	married
巫術	witchcraft
巫術	sorcery
巫術	sorceries
巫師	sorcerers
巫師	sorcerer
巫婆	sorceress
巨石	boulders
巨浪	billow
巨大	tremendous
巨大	immense
巨大	huge
巨大	enormously
巨大	enormous
巨人	Goliath
巨人	giant
巧妙	cleverly
巧合	coincidence
工頭	foremen
工資	wages
工資	wage
工資	pay
工藝	crafts
工匠	craftsmen
工具	tools
工具	tool
工作	worked
工作	work
工作	jobs
工作	job
工人	workmen
工人	workman
工人	workers
工人	worker
巢穴	hideout
巢穴	den
巡邏	patrolled
巡邏	patrol
巡遊	prowls
州長	governors
州長	governor
嵌縫	caulking
嵌套	nested
崩潰	crumble
崩潰	collapses
崗樓	watchtower
崗位	post
崎嶇	rugged
崇高	loftiness
崇拜	worships
崇拜	worshiping
崇拜	worshiped
崇拜	worship
崇拜	adore
崇拜	adoration
峽谷	gorge
島嶼	islands
峰巔	hilltops
峭壁	crags
峨山	Eshan
岸上	ashore
岳父	father-in-law
岳母	mother-in-law
岩石	rocky
岩石	rocks
山麓	foothills
山頂	mountaintops
山頂	mountaintop
山頂	hilltop
山谷	valleys
山腰	mountainsides
山腰	mountainside
山羊	ibex
山羊	goats
山羊	goat
山溝	ravine
山洪	torrents
山坡	hillsides
山坡	hillside
屬於	belongs
屬於	belonging
屬於	belonged
屬於	belong
屬性	property
屬伯	Ibleam
履行	fulfillment
履行	fulfilling
履行	fulfill
屠殺	massacre
屠殺	butchered
屠宰	slaughtering
屠宰	slaughtered
屠宰	slaughter
屠宰	butchering
屠夫	butcher
展開	unrolled
展覽	exhibition
展示	showing
展示	exhibit
屏障	barrier
屏蔽	shield
屍體	corpses
屍體	corpse
屍體	carcasses
屋頂	rooftops
屋頂	rooftop
屋頂	roofs
屋頂	roof
屋頂	housetop
屈辱	humiliation
屈尊	condescension
居民	residents
居民	resident
居民	inhabitants
居民	inhabitant
居民	dwellers
居住	inhabited
屁股	butt
局部	partial
尾巴	tails
尾巴	tail
尼波	Nebo
尼母	Nemuel
尼斐	Nepheg
尼探	Nethaniah
尼姑	Nun
尼哥	Neco
尼哈	Phinehas
尼八	Nebat
尼亞	Neah
尼亞	Ananias
尺寸	size
尺寸	dimensions
尷尬	embarrassed
就讀	enrolled
就業	employed
就听	hears
尤其	particularly
尖銳	sharp
尖細	shrieked
尖叫	shrieking
尖叫	screech
尖叫	screaming
尖叫	screamed
尖刻	biting
少數	handful
少數	few
少女	maidens
少女	maiden
小麥	wheat
小鹿	fawns
小馬	colt
小雨	sprinkles
小雞	chicks
小野	Ono
小費	tipping
小費	tip
小販	hucksters
小說	fictions
小號	trumpets
小號	s
小米	millet
小瓶	vial
小狗	dogs
小牛	calves
小牛	calf
小氣	stingy
小氣	mean-spirited
小時	hours
小時	hour
小憩	nap
小怪	mobs
小心	lookout
小心	carefully
小心	careful
小巷	alleys
小姐	miss
導遊	guides
導致	resulted
導演	directing
對面	opposite
對象	objects
對話	conversations
對照	comparison
對沖	hedges
對比	contrast
對於	for
對接	butted
對抗	rivalry
對手	rivals
對手	rival
對手	opponents
對手	opponent
對手	adversary
對手	adversaries
對待	treats
對待	treat
尋求	seeks
尋求	seek
尊重	respects
尊重	respect
尊重	esteem
尊重	deference
尊敬	reverence
尊敬	revered
尊敬	revere
尊敬	respectfully
尊敬	respected
尊敬	esteemed
尊嚴	dignity
專用	dedicated
專家	experts
專家	expert
專一	single-minded
將軍	generals
射線	ray
射擊	shot
射擊	shooting
射擊	shoot
射手	marksmen
射手	archer
封閉	enclosed
封盤	entertained
寺廟	temples
寺廟	temple
寶藏	treasure
寶石	gemstones
寶石	gems
寶石	gem
寶庫	treasure-house
寶座	thrones
寶屋	treasure-houses
寶寶	baby
寵物	pet
寵兒	darling
寬敞	spacious
寬恕	forgave
寬度	width
寬容	tolerant
寬容	forgiving
寫作	writing
審訊	trial
審查	scrutinized
審問	interrogated
審問	interrogate
寧願	preferring
寧拉	Nimrah
實踐	practice
實現	realizing
實現	realized
實現	realize
實現	realization
實現	achieved
實抹	Basemath
實各	Eshcol
實例	instances
寢具	bedding
寡婦	widows
寡婦	widow
寓言	parable
富裕	wealthy
富有	riches
密迦	Milcah
密謀	conspired
密封	sealing
密封	sealed
密封	seal
密奪	Migdol
密列	Melea
密切	closely
寂靜	stillness
寂靜	quietness
寂靜	hushed
容貌	looks
容易	readily
容易	likely
容易	liable
容易	easily
容忍	tolerate
容器	container
家長	patriarch
家鄉	hometown
家譜	genealogy
家譜	genealogies
家畜	livestock
家庭	household
家庭	family
家庭	families
家屬	dependents
家園	homes
家園	homeland
家具	furniture
家具	furnishings
宴請	feasted
宴會	banquets
宴會	banquet
害怕	feared
害怕	afraid
宮殿	palaces
宦官	eunuch
室內	interior
宣講	proclaiming
宣講	preached
宣誓	oaths
宣言	pronouncement
宣稱	profess
宣揚	preaches
宣布	proclaim
宣布	declare
宣布	announcing
宣布	announces
宣布	announce
宣告	pronounces
宣判	sentencing
宣判	pronounced
宣傳	propaganda
客房	rooms
客戶	client
客人	guest
定義	defines
定義	defined
定罪	conviction
定罪	convict
定期	regular
官方	official
官員	officials
官僚	bureaucracy
宗教	religious
宗教	religions
宗教	religion
完美	perfectly
完美	perfection
完美	faultless
完整	intact
完成	fulfilled
完成	completion
完成	completing
完成	completed
完成	complete
完成	accomplishes
完成	accomplished
完成	accomplish
完善	perfecting
完善	perfected
完善	perfect
完全	utterly
完全	totally
完全	entirely
安靜	silence
安靜	quieter
安靜	quiet
安裝	mounting
安裝	mounted
安裝	mount
安裝	installing
安裝	installed
安裝	install
安置	resettling
安置	resettled
安置	resettle
安爾	Aner
安營	Jeshimon
安然	safely
安然	peacefully
安撫	appease
安排	arrangements
安排	arrangement
安排	arranged
安排	arrange
安慰	soothed
安慰	consoling
安慰	consoled
安慰	console
安慰	comfort
安息	rip
安心	relieved
安定	settled
安娜	Anna
安卡	Anak
安全	security
安全	securely
安全	secured
安全	secure
安全	safety
安全	safe
守門	gatekeepers
守衛	guarded
守衛	guard
守著	guarding
宇宙	universe
它的	its
學費	tuition
學者	scholars
學習	learning
學習	learn
學科	subject
學科	disciplines
學科	discipline
學生	student
孵化	hatching
孵化	hatch
孫子	grandsons
孫子	grandson
孫子	grandchildren
孫女	Mehetabel
孫女	granddaughters
孫女	granddaughter
孩子	kids
孩子	children
孤立	isolated
孤獨	lonely
孤單	lone
孤兒	orphans
孤兒	orphan
孤兒	fatherless
季節	seasons
季節	season
季拉	gerahs
孚尼	Jephunneh
存款	deposit
存在	presence
存在	exists
存在	existence
存在	existed
存在	exist
存在	being
存儲	storing
存儲	stored
存儲	storage
字符	character
孕育	bred
孔雀	peacocks
子宮	wombs
子宮	womb
子孫	offspring
嬰兒	infants
嬰兒	infant
嬰兒	babies
嫌疑	suspected
嫉妒	jealously
嫉妒	envying
嫂子	sister-in-law
嫁接	grafted
嫁妝	dowry
媽媽	Mama
媳婦	daughter-in-law
媒體	Media
媒介	mediums
婦女	women
婢女	handmaid
婚禮	weddings
婚禮	wedding
婚姻	marriages
婚姻	marriage
婆媽	foolishly
娛樂	entertainment
娛樂	entertaining
娛樂	amusement
威風	imposing
威脅	threats
威脅	threatens
威脅	threaten
威脅	threat
威武	mighty
威嚴	majesty
威嚴	awe
威嚇	intimidate
威力	might
姦淫	adulterers
姦污	ravished
姦夫	adulterer
委託	entrusts
委託	entrusting
委託	entrusted
委託	entrust
委託	commissioned
委曲	perverting
委屈	wronged
姑媽	aunt
姐妹	sisters
始終	throughout
妻子	wives
妻子	wife
妹妹	sister
妥協	compromise
妖嬈	enchanting
妖媚	seductive
妓院	brothels
妓女	whores
妓女	whore
妓女	prostitutes
妓女	prostitute
妒忌	jealousy
妄言	raved
妄想	delusion
如飛	swiftly
如果	if
如實	truthfully
如下	follows
好處	favors
好處	benefits
好看	good-looking
好奇	curious
她的	hers
她的	her
奸詐	treacherous
奸商	shortchange
奶牛	cows
奶油	cream
奶昔	shakes
奴隸	slaves
奴隸	slave
奴役	enslaves
奴役	enslaved
奴役	enslave
女神	goddess
女王	queen
女性	females
女巫	witches
女孩	girls
女孩	girl
女婿	son-in-law
女兒	daughters
女兒	daughter
女傭	maids
女傭	maid
女人	woman
奧秘	mysteries
奧倫	Oren
套索	noose
契約	covenants
契據	deed
奉獻	devote
奉獻	dedicate
奉承	flatter
奈恩	Nain
奇蹟	wonders
奇蹟	wonder
奇蹟	miracles
奇蹟	miracle
奇怪	strangely
奇怪	strange
奇妙	wondrous
奇妙	wonderfully
奇妙	marvelous
夾緊	clamped
夾板	splint
夾子	clamps
夾克	jacket
夸脫	quarts
夸脫	quart
失踪	missing
失語	muteness
失望	disappointment
失望	disappointed
失明	blindness
失明	blinded
失敗	failure
失敗	fails
失敗	failing
失敗	failed
失敗	fail
失控	uncontrollably
失去	losing
失去	loses
失去	lose
失利	loss
失事	wrecked
太陽	sun
太監	eunuchs
太古	immemorial
天賦	talent
天賦	endowed
天空	sky
天空	skies
天生	born
天氣	weather
天才	talented
天才	gifted
天堂	paradise
天堂	heaven
天使	archangels
天使	archangel
天使	angels
天使	angelic
天使	angel
天上	heavenly
大鼠	rats
大麥	barley
大風	gale
大雅	Pedaiah
大雅	Jedaiah
大陸	mainland
大錘	sledgehammers
大量	considerable
大車	cart
大衣	coats
大衛	David
大蒜	garlic
大致	roughly
大膽	daring
大膽	boldly
大腿	thighs
大腿	thigh
大腦	brains
大能	almighty
大綱	outline
大碗	bowlful
大片	expanses
大火	blazes
大漢	Tahan
大步	stalked
大概	probably
大桶	vats
大廳	halls
大廳	hall
大幅	sharply
大家	everyone
大坍	Dathan
大喜	exultation
大叫	yelled
大力	vigorously
大利	Gedaliah
大使	ambassadors
大使	ambassador
夥伴	partners
夥伴	partner
夢見	dreamed
夢想	dream
多頭	longs
多變	varied
多葉	leafy
多益	Doeg
多爾	Dor
多森	Dothan
多數	majority
多情	passionate
外部	external
外衣	garb
外甥	nephew
外人	outsiders
夏甲	Hagar
夏瑣	Hazor
夏季	summer
壯麗	magnificence
壯觀	spectacular
士兵	soldiers
士兵	soldier
壟斷	monopoly
壞蛋	wretches
壞蛋	scoundrels
壞蛋	rascal
壞處	disadvantage
壞人	wrongdoer
壞事	wrongdoing
壞事	villainy
壓迫	oppression
壓迫	oppressing
壓迫	oppresses
壓迫	oppressed
壓迫	oppress
壓痛	tenderness
壓抑	pent
壓抑	oppressive
壓抑	depressing
壓扁	squashed
壓延	rolling
壓力	pressures
壓力	pressure
壓制	pressed
壓倒	overwhelming
壓倒	overwhelm
壓倒	overpowers
壓倒	overpower
壇子	jug
壁龕	alcoves
壁虎	gecko
壁爐	fireplaces
壁爐	fireplace
壁櫥	closet
壁架	ledges
墳墓	graves
墮落	fallen
墮落	depraved
墨水	ink
增長	grow
增加	increasing
增加	increases
增加	increased
增加	increase
增加	adds
墜毀	crashed
墓葬	tombs
墓旁	graveside
墓地	graveyard
墓地	Golgotha
境界	realms
填充	populate
填充	fills
填充	filling
填充	filled
塞拉	Sela
塗抹	smearing
塗抹	smear
塗抹	blotted
塗層	coat
塌陷	subside
場面	spectacle
場合	occasions
場合	occasion
報警	alarm
報復	retaliated
報復	retaliate
報導	reported
報告	reports
報告	reporting
報告	report
報價	offers
報仇	avenge
堡壘	forts
堡壘	fortresses
堡壘	fortress
堡壘	citadels
堡壘	citadel
堅決	resolutely
堅果	nuts
堅果	nut
堅持	uphold
堅持	upheld
堅持	persisted
堅持	persist
堅持	insists
堅持	insisting
堅持	insistent
堅持	insisted
堅定	steadfast
基順	Kishon
基達	Kedar
基遍	Gibeonites
基遍	Gibeonite
基遍	Gibeon
基述	Geshurites
基述	Geshur
基訓	Gihon
基色	Gezer
基羅	Eliam
基綠	Keros
基納	Kenath
基礎	foundation
基礎	basis
基礎	base
基石	cornerstone
基督	Christ
基爾	Kir
基柄	Gebim
基本	basics
基本	basic
基於	based
基提	Kittim
基拉	Gerar
基尼	Kenites
基尼	Kenite
基多	Gedor
基地	bases
基列	Gileadites
基列	Gileadite
基倫	Kitron
基什	Kish
培養	train
培育	cultivating
培育	cultivate
執行	performing
執行	performed
執行	execution
執行	executing
執行	executed
執行	execute
執行	comply
執著	clinging
執事	deacons
執事	deacon
城牆	ramparts
城市	towns
城市	cities
城垛	battlements
埋葬	bury
埃蘭	Elamites
埃蘭	Elam
埃拉	Ela
埃及	Egypt
埃丁	Adin
垃圾	trash
垃圾	rubbish
垃圾	refuse
垃圾	garbage
垂耳	lop
垂直	plumb
垂死	dying
坦白	confesses
坦率	frankness
坦克	tank
坡道	ramps
坐鎮	sits
坐墊	cushion
坐在	sitting
坐在	seated
坍方	collapse
均衡	balanced
地點	place
地點	locations
地面	ground
地震	quakes
地震	quake
地震	earthquakes
地震	earthquake
地穴	Anub
地球	earth
地獄	underworld
地獄	hell
地獄	he'll
地牢	dungeons
地牢	dungeon
地毯	rugs
地毯	carpets
地段	lots
地板	floors
地板	floor
地方	places
地塊	plots
地址	address
地圖	map
地區	regions
地區	region
地主	landowner
地下	underground
在位	reigned
土明	Thummim
土墩	mounds
土塊	clods
土地	lands
土地	land
土匪	bandit
團結	uniting
團結	unite
團結	rally
團塊	clumps
圖表	chart
圖片	pictures
圖片	picture
圖片	images
圖片	image
圖案	patterned
圖書	books
圓周	circumference
園丁	gardener
圍觀	onlookers
圍裙	apron
圍繞	revolves
圍欄	fences
圍攻	mobbed
圍攻	besieging
圍攻	besieged
圍攻	besiege
圍巾	scarves
圍城	siege
國際	international
國籍	nationality
國界	borders
國王	kings
國王	king
國民	national
國家	nations
國家	nation
國家	country
國家	countries
國外	foreign
國外	abroad
國內	domestic
國內	civil
國債	treasuries
圈套	snare
固體	solid
固定	retaining
固定	fixed
固定	fix
固定	fastened
固執	stubbornness
困難	difficulty
困難	difficulties
困窘	embarrassment
困擾	plagued
困擾	bothering
困擾	bothered
困擾	afflicting
困惑	puzzled
困惑	perplexed
困惑	confused
困惑	baffled
困境	woes
困境	predicament
困境	plight
囤積	hoarded
因為	because
因此	therefore
回覆	re
回答	replied
回答	answering
回答	answered
回答	answer
回收	reclaim
回應	responded
回憶	memories
回复	reply
回复	replies
回報	returns
回報	repays
回國	returning
回合	round
四肢	limbs
四肢	fours
四月	April
四方	four-sided
四十	forty
囚禁	imprisoned
囚禁	captivity
囚犯	prisoners
囚犯	prisoner
嚴重	severely
嚴重	severe
嚴重	serious
嚴重	heavily
嚴肅	stern
嚴肅	seriousness
嚴正	sternly
嚴格	strictness
嚴格	strictly
嚴格	strictest
嚴格	strict
嚴格	demanding
嚮往	yearned
嚮往	yearn
嚎叫	howling
嚇唬	frighten
嚇倒	intimidated
噴薄	gushing
噴漿	Gunite
噴泉	fountains
噴泉	fountain
噴口	spout
噪聲	noise
噩夢	nightmares
器物	implements
器官	organs
嘶鳴	neighing
嘶叫	bray
嘴饞	tempts
嘴硬	fooling
嘴巴	mouths
嘴唇	lips
嘲諷	taunt
嘲諷	mocking
嘲笑	scoffs
嘲笑	scoffing
嘲笑	scoff
嘲笑	ridiculing
嘲笑	ridicule
嘲笑	mocks
嘲笑	mocked
嘲笑	mock
嘲笑	jeered
嘲笑	jeer
嘲笑	deride
嘲弄	taunts
嘲弄	taunted
嘲弄	mockingly
嘮叨	nagging
嘟囔	grumbled
嘗試	try
嘗試	tries
嘗試	attempts
嘗試	attempting
嘗試	attempted
嘗試	attempt
嘔吐	vomit
嘈雜	noisy
嘆息	sighing
嘆息	groanings
嗜血	bloodthirsty
嗚嗚	whining
嗚嗚	blare
嗚咽	sobs
嗅探	sniffing
單薄	flimsy
單獨	alone
單挑	singled
單元	unit
單位	units
喬達	Joda
喬爾	Joel
喪失	forfeit
喝道	shouted
喜歡	likes
喜歡	liked
喜歡	like
喜歡	fond
喜愛	loved
喜愛	favorite
喜悅	joy
喜人	delighting
喚醒	wakened
喚醒	waken
喚醒	wake
喚醒	rouse
喘氣	pant
喘氣	gasps
喘氣	gasping
喘氣	gasp
喊叫	outcry
喊叫	exclaim
喉嚨	throats
喇合	Rahab
喇叭	trumpet
喇叭	horn
善良	kindness
善良	goodness
善意	goodwill
喃喃	muttered
啥樣	sawed
啤酒	beer
啟閉	shuts
啟示	revelations
啟示	revelation
啟發	inspired
啟發	inspire
啟用	enabled
啟封	unsealed
啟封	Unseal
啟動	starts
問題	questions
問題	problems
問題	problem
問題	issue
問責	accountable
問候	regards
問候	greetings
商標	trademark
商榷	deliberate
商業	commerce
商業	business
商店	stores
商店	store
商店	shops
商家	merchants
商品	wares
商品	merchandise
商人	trader
商人	merchant
唾液	saliva
唾沫	spittle
唾棄	spurned
唱歌	singing
唬弄	Yanking
哽咽	choked
哲學	philosophy
哭聲	cries
哭泣	wept
哭泣	weeps
哭泣	weep
哭泣	sob
哭了	crying
哭了	cried
哪裡	wherever
哪裡	where
哨兵	sentry
哨兵	sentries
哨兵	sentinels
哥巴	Geba
哥哥	brother
員工	staffs
員工	staff
員工	hires
哈馬	Hamathites
哈馬	Hamath
哈順	Hashum
哈隆	Jalon
哈達	Hadad
哈達	Ben-hadad
哈諾	Hanoch
哈蘭	Haran
哈薛	Haziel
哈薛	Hazael
哈蒙	Hammon
哈臘	Halah
哈突	Hattush
哈曼	Haman
哈摩	Hashmonah
哈拉	Hariph
哈拉	Haradah
哈拉	Halak
哈抹	Hamor
哈及	Haggith
哈博	Habor
哈南	Hanan
哈利	Hali
哄騙	lulled
哄然	boisterous
品脫	pints
品脫	pint
品種	variety
品種	varieties
品種	breed
品牌	makes
品牌	branded
品嚐	savored
哀號	wailed
哀號	wail
哀悼	mourns
哀悼	mourned
哀思	grief
哀嘆	lament
咬緊	clench
咬定	insist
咬傷	bites
咩咩	bleating
咕噥	muttering
咕噥	mutter
咕咕	cooing
咒語	incantation
咒罵	cursing
和諧	harmony
和解	reconciliation
和藹	kindly
和睦	peaceably
和弦	chords
和平	peace
咋舌	breathless
咆哮	snarled
咆哮	roaring
咆哮	ranting
咀嚼	chewing
命運	fortunes
命運	fate
命運	destiny
命脈	lifeblood
命名	naming
命名	named
命令	orders
命令	commands
命令	command
呼吸	breathing
呼吸	breathe
呼吸	breath
呼叫	call
呻吟	moans
呻吟	moaning
呻吟	moaned
呻吟	moan
呻吟	groans
呻吟	groaned
呻吟	groan
味道	taste
味道	flavor
周圍	surrounding
周圍	around
周到	considerate
告訴	told
告訴	tells
告訴	telling
告訴	tell
告別	farewells
告別	farewell
呈現	rendered
呈現	presenting
呈現	presented
呂馬	Elymas
吹牛	bragging
吹牛	braggarts
吹牛	brag
吹噓	bragged
吹噓	boasted
吸盤	suckers
吸收	absorbed
吸引	attracted
吸引	attract
吵架	quarrel
吮吸	suck
含蓄	veiled
含義	meanings
含義	meaning
否認	denies
否認	denied
吠聲	growl
吞食	swallowed
吞食	devouring
吞食	devour
吞沒	engulfs
吞沒	engulfed
吞嚥	swallowing
吞噬	devours
吞噬	devoured
吝嗇	tightfisted
吝嗇	begrudging
君主	Sovereign
君主	monarchs
向西	westward
向外	outwardly
向外	outward
向南	southward
向前	onward
向前	forth
向下	downward
向上	upward
向上	up
吐氣	breathes
吐奶	spits
名譽	fame
名聲	renown
名稱	name
名單	lists
名單	list
同胞	countrymen
同樣	similarly
同樣	likewise
同意	consented
同意	consent
同意	agrees
同意	agreeing
同意	agreed
同意	agree
同情	sympathy
同情	sympathize
同情	compassion
同性	homosexual
同伴	fellow
同伴	companions
同事	colleagues
同事	co-worker
吊裝	lifting
吊繩	sling
吊墜	pendants
吉甲	Gilgal
吉德	Giddel
合謀	conspiring
合謀	conspire
合算	worthwhile
合理	reasonable
合法	lawful
合法	authorized
合格	qualified
合格	eligible
合意	desirable
合徵	co-sign
合式	well-formed
合唱	chorus
合同	deal
合同	contract
合力	Heli
合作	cooperation
合作	cooperated
合作	cooperate
各自	respective
各個	various
吃驚	shocked
吃驚	amazed
吃飽	gorged
吃過	eaten
司機	drivers
司機	driver
司得	Lystra
司令	commanding
右手	right-hand
史昂	Shion
台島	Toi
可靠	trustworthy
可靠	reliable
可鄙	contemptible
可見	visible
可能	possible
可能	may
可疑	suspicious
可拉	Korahites
可拉	Korah
可憐	wretched
可憐	pity
可憐	pitied
可愛	lovely
可愛	lovelier
可惡	hateful
可惡	abominable
可恨	detestable
可恥	shamefully
可恥	shameful
可恥	disgraceful
可怕	terribly
可怕	terrible
可怕	horrible
可怕	hideous
可怕	fearfully
可怕	fearful
可怕	dreadful
可怕	awful
可口	tasty
可信	faithful
可以	could
召開	convened
召回	recall
召喚	summoning
召喚	summon
叫好	applauds
叫好	applauded
叫囂	clamor
叫嚷	blustering
叫喊	shouting
只要	only
只是	simply
只是	just
句子	sentence
古老	age-old
古珊	Cushan
古爾	Gur
古實	Cushite
古實	Cush
口音	accent
口譯	interpreters
口袋	pockets
口袋	pocket
口渴	thirst
口才	eloquence
口味	tastes
叛逆	treason
叛逃	defecting
叛逃	defected
叛軍	rebels
叛徒	traitors
叛徒	traitor
叛亂	rebellions
受驚	frightened
受難	crucifixion
受限	confined
受阻	hindered
受阻	blocked
受辱	insulted
受辱	dishonored
受賄	bribery
受虐	battered
受精	fertilized
受益	benefited
受洗	baptized
受控	controlled
受挫	thwarted
受挫	frustrated
受戒	ordained
受傷	injuring
受傷	injuries
受傷	injured
取締	outlawed
取締	outlaw
取締	banned
取消	withdrawn
取消	lifted
取消	cancels
取消	canceling
取消	canceled
取消	cancel
取消	abolished
取悅	pleaser
取代	substituted
叔叔	uncles
叔叔	uncle
反駁	retorted
反駁	retort
反駁	refute
反駁	countered
反映	reflects
反映	reflecting
反映	reflect
反應	reaction
反應	reacted
反彈	bounced
反常	pervert
反對	opposition
反對	opposing
反對	opposes
反對	opposed
反對	oppose
反對	objections
反對	objected
反對	against
反复	repeatedly
反叛	revolt
反叛	rebelling
反叛	rebel
友誼	friendship
友誼	companionship
友善	friendly
及時	Timely
及時	promptly
叉子	forks
叉子	fork
參觀	visited
參與	participation
參與	involved
參考	reference
參考	refer
參數	arguments
參孫	Samson
參天	towering
參加	participated
參加	participate
參加	partake
去除	removing
去除	removed
去皮	peeled
去掉	remove
厭惡	loathes
厭惡	loathed
厭惡	loathe
厭惡	distaste
厭惡	disgust
厭惡	abomination
厭倦	weary
厭倦	wearied
原諒	forgives
原諒	forgiven
原諒	forgive
原諒	excused
原種	elite
原理	principle
原因	reasons
原因	reason
原因	causes
原因	cause
原告	accusers
原告	accuser
原則	principles
厄運	doom
厄斯	Tiberius
卸載	unloaded
卸貨	discharge
卸下	unload
卷鬚	tendrils
即時	immediate
即刻	instantly
危險	dangers
危險	dangerous
危險	danger
危機	crisis
危害	harms
危害	harm
危害	endanger
印跡	blotting
印跡	blots
印象	impression
印章	chops
印度	India
卡蒙	Kamon
卡納	Cana
卡米	Carmi
卡住	stuck
卜筮	divination
博昂	Bohan
博學	educated
南寧	Aiath
協議	pact
協議	agreement
協助	assisting
卓越	remarkable
卓越	excellence
卑鄙	meanness
卑鄙	despicable
卑賤	lowly
卑劣	vileness
半燒	half-burned
午餐	luncheon
午餐	lunch
午夜	midnight
升起	rising
升值	appreciation
千鈞	supremely
十月	October
十弦	ten-stringed
十四	fourteen
十六	sixteen
十八	eighteen
十五	fifteen
十二	twelve
十九	nineteen
十三	thirteen
十七	seventeen
十一	eleven
區別	distinguishing
區別	discrimination
區別	difference
區分	distinguish
匿伏	lurk
匹配	matched
匯集	converge
北方	northward
北方	northern
化妝	makeup
匕首	daggers
匕首	dagger
匆忙	hurry
匆匆	hurriedly
包裹	wrapped
包裹	parcels
包裝	wraps
包紮	bandaged
包皮	foreskins
包皮	foreskin
包括	includes
包括	included
包括	include
包圍	surrounded
包圍	hemmed
包圍	encircled
包圍	encircle
包含	including
包含	contains
包含	contain
勾銷	nullifies
勾引	tempt
勾引	seduce
勸告	counseled
勸告	advise
勤奮	diligent
勤勞	industrious
勤勉	diligence
勞碌	toils
勞動	labor
勝利	winning
勝利	victory
勝利	victories
勝利	triumphed
勝利	triumph
勝任	competent
動量	momentum
動盪	turmoil
動畫	Anim
動物	animals
動物	animal
動機	motives
動機	motive
動機	motivated
動搖	wavers
動搖	wavered
動搖	waver
動搖	swayed
動搖	shaken
動心	tempted
動員	mobilizing
動員	mobilized
動員	mobilize
勒索	extortioners
勒索	extorting
勒索	extorted
勒索	extort
勒死	strangled
勒撒	Rissah
勒住	reined
勉強	reluctantly
勉強	grudgingly
勇氣	courage
勇敢	courageous
勇敢	brave
勇士	warriors
勃然	excitedly
劫財	robbing
劫匪	robbers
努力	efforts
助理	assistants
助理	assistant
助攻	assist
助手	aides
加馬	Gamaliel
加重	aggravated
加迪	Gadi
加迪	Gaddi
加載	load
加薪	raises
加盟	joining
加盟	joined
加略	Kerioth
加熱	heated
加深	deepens
加沙	Gaza
加成	addition
加強	strengthened
加強	strengthen
加強	stepped
加強	reinforced
加強	Reinforce
加布	Carpus
加工	working
加劇	aggravate
加冕	crowning
加冕	crowned
加冕	coronation
加入	joins
加入	join
加入	adding
加侖	gallons
加侖	gallon
功能	function
功績	feat
功率	power
功夫	effort
功勳	feats
劑量	dose
劍士	swordsmen
劈柴	woodchoppers
劈柴	kindling
劈啪	crackled
劃分	divide
剷除	uproot
創建	creation
創建	creating
創建	creates
創建	created
創建	create
割禮	circumcision
割禮	circumcising
割禮	circumcised
割禮	circumcise
副歌	refrain
副本	copies
副手	lieutenants
剪毛	shorn
剪毛	shearing
剪斷	shear
剪切	sheared
剩餘	surplus
剩下	left
剝離	stripping
剝離	stripped
剝奪	deprived
剝奪	deprive
前額	forehead
前鋒	forward
前進	advancing
前輩	senior
前輩	predecessors
前線	battlefront
前沿	frontiers
前夕	Eve
前哨	outposts
前哨	outpost
前任	predecessor
削減	slash
削減	cuts
削弱	weakens
削弱	weaken
削弱	Cripple
削尖	sharpened
削尖	sharpen
剃刀	razor
剃光	shaved
刻薄	unkind
刺繡	embroidery
刺繡	embroiderers
刺穿	pierces
刺穿	pierced
刺穿	pierce
刺穿	impaled
刺穿	impale
刺痛	stung
刺痛	stinging
刺激	stimulate
刺激	irritate
刺槐	locust
刺槐	acacia
刺棒	goad
刺客	assassins
刷牆	whitewashers
刷新	refreshes
刷新	refreshed
刷新	refresh
制皮	leatherworker
制服	uniforms
制服	uniform
制服	subdued
制服	overpowered
制定	instituted
制勝	subdues
到達	reaching
到達	reaches
到達	reached
到達	arriving
到達	arrives
到達	arrived
到達	arrive
到達	arrival
到處	everywhere
到期	maturity
刮出	scrapings
利雅	Athaliah
利達	Lydda
利肯	Rekem
利益	interests
利益	interest
利甲	Recab
利用	exploiting
利用	exploited
利用	exploit
利潤	profits
利潤	profit
利沙	Elishah
利比	Sherebiah
利差	spreads
利合	Rehob
利加	Elkanah
利健	Regem
利亞	Leah
別處	elsewhere
別加	Perga
判斷	judgments
判斷	judgment
判斷	judging
判斷	judged
判刑	sentenced
初熟	firstfruits
列維	Levi
划船	rowing
刑事	criminal
切除	removal
切絲	shredded
切斷	severing
切斷	severed
切實	earnestly
切割	cutting
分類	sort
分類	classified
分離	separating
分離	separated
分離	separate
分離	detachment
分隊	detachments
分鐘	minutes
分鐘	minute
分配	distribution
分配	distributes
分配	assigning
分配	assigned
分配	assign
分配	allotted
分贓	spoils
分裂	split
分裂	splintered
分發	distribute
分為	divided
分毫	hairsbreadth
分歧	divides
分歧	disagreements
分歧	differences
分析	analyze
分數	marks
分散	scatter
分散	dispersed
分散	disperse
分手	parted
分心	distractions
分心	distracting
分子	elements
分娩	childbirth
分娩	birth
分區	partitioned
分割	separation
分別	separately
分別	distinction
分佈	distributions
分佈	distributing
分享	sharing
分享	shares
分享	share
出院	discharged
出逃	flees
出血	hemorrhage
出色	brilliantly
出租	rental
出租	rent
出租	letting
出發	departing
出生	births
出現	emerge
出現	arose
出現	arises
出現	arise
出現	appears
出現	appearing
出現	appeared
出現	appearance
出現	appear
出沒	infested
出沒	haunts
出沒	haunt
出席	attending
出席	attended
出席	attend
出售	sold
出口	exit
出動	dispatched
凹進	recessed
凱撒	Caesar
凱因	Kain
凱南	Kenan
凡人	mortals
凡人	mortal
凝視	staring
凝視	peered
凝視	gazing
凝視	gazed
凝視	gaze
凝塊	Gob
凝乳	curds
凜然	awe-inspiring
凍結	freezes
冷靜	calm
冷笑	sneered
冷笑	sneer
冷漠	indifferent
冷杉	firs
冷杉	fir
冷卻	cooling
冷卻	cooled
冷凍	freezing
冶煉	smelt
冰雹	hailstones
冰雹	hail
冬季	winter
冤屈	wrongs
冠軍	champion
冒險	venture
冒險	risked
冒著	risking
冒犯	offends
冒瀆	sacrilege
冒泡	bubbling
冒泡	bubbled
冒充	imitating
再見	good-bye
再續	adjourned
再現	reappeared
再現	reappearance
再次	again
再婚	remarry
再婚	remarries
具體	specific
具有	possess
具有	has
其餘	remaining
其次	followed
其實	actually
其他	others
其他	other
其他	else
其中	among
共計	totaling
共治	governs
共同	common
共享	shared
六月	June
六十	sixty
公雞	rooster
公開	publicity
公路	highways
公豬	boar
公認	accepted
公羊	rams
公牛	bulls
公牛	bull
公然	publicly
公然	openly
公民	civic
公民	citizens
公民	citizen
公正	impartial
公平	fairness
公平	fair
公寓	flats
公墓	cemetery
公園	parks
公告	proclamation
公告	announcement
公司	firm
公司	company
公佈	announced
公主	princess
八月	August
八卦	gossip
八十	eighty
兩聲	mutterings
兩次	twice
兩刃	two-edged
兩側	flanked
全然	completely
全年	annual
全國	nationwide
內陸	inland
內部	internal
內部	insides
內裡	Neri
內衣	underclothes
內置	built
內容	content
入選	inducted
入迷	enchanted
入口	entryway
入口	entrances
入口	entrance
入侵	invading
入侵	invaded
入侵	invade
入住	stays
入伍	enlisted
兒童	child
兒子	sons
兒子	son
免除	absolved
免得	lest
兌換	convert
克服	overcomes
克服	overcome
克勞	Claudius
克制	restraint
光頭	baldhead
光環	halo
光澤	sheen
光澤	luster
光滑	smooth
光滑	sleek
光榮	honorably
光榮	gloriously
光柵	grating
光束	beam
光明	brighter
光彩	honorable
先鋒	herald
先祖	patriarchs
先知	prophets
先生	sir
先於	precedes
先前	previously
兇猛	fiercest
兇手	murderer
充電	charging
充足	adequate
充滿	fullness
充斥	glutted
充分	fully
充分	full
兄弟	brothers
元帥	Marshal
允許	permitting
允許	permitted
允許	permission
允許	allows
允許	allowing
允許	allowed
允許	allow
優點	advantages
優點	advantage
優雅	gracefully
優雅	elegant
優越	superior
優美	graceful
優秀	outstanding
優秀	excellent
優於	precede
優惠	preferential
償還	repay
償還	repaid
儘管	spite
儘管	despite
儀式	rituals
儀式	ritually
儀式	ritual
儀式	rites
儀式	rite
儀式	observance
儀式	ceremony
儀式	ceremonies
儀式	ceremonially
儀式	ceremonial
儀器	instruments
儀器	instrument
價錢	price
價格	prices
價值	worth
價值	valued
僱用	hired
僱員	employees
僕人	servant
僅僅	merely
僅僅	barely
傾覆	topple
傾覆	overturning
傾斜	tilt
傾斜	slant
傾倒	dump
傻瓜	simpletons
傻瓜	simpleton
傻瓜	fools
傻子	fool
傷處	injures
傷痕	welts
傷疤	scars
傷心	sad
傷心	grieved
傷害	hurts
傷害	hurting
傷害	hurt
傷害	harmed
傷口	wounds
傷口	wound
傷人	wounding
傷亡	casualties
債務	debts
債務	debt
債券	bonds
傳達	convey
傳道	preach
傳輸	transporting
傳說	legends
傳言	rumblings
傳聞	rumors
傳聞	hearsay
傳統	traditions
傳統	traditional
傳統	tradition
傳播	spreading
傳播	spread
傳喚	summoned
傲然	proudly
傲氣	haughtiness
傲慢	insolence
傲慢	haughty
傲慢	arrogantly
傲慢	arrogant
傲慢	arrogance
備註	remarks
備用	spare
備用	alternate
備件	spares
傑西	Jesse
傑作	masterpiece
偽造	counterfeit
偽裝	disguised
偽裝	disguise
偷聽	overheard
偷偷	secretly
偷了	stole
偶然	accidentally
偶然	accidental
偶像	idols
偶像	idol
偵察	scouting
偵察	scout
側翼	flank
側翻	overturns
健談	talkers
健忘	forgetfulness
健康	wholesome
健康	healthy
健康	healthier
健康	health
停頓	standstill
停靠	docked
停產	discontinued
停止	stops
停止	stopping
停止	stopped
停止	stop
停止	ceased
停止	cease
做法	practices
做工	workmanship
做夢	dreaming
偏離	deviate
偏愛	preference
偏愛	favoritism
偏愛	favor
偏心	partiality
偉大	greatness
假設	suppose
假設	assuming
假裝	pretends
假裝	pretending
假裝	pretend
假期	holidays
假日	holiday
假意	hypocrisy
假想	imaginary
假定	presumed
假定	assumed
值得	worthy
值得	deserving
值得	deserves
值得	deserve
借閱	borrows
借給	lent
借給	lends
倖存	surviving
倖存	survived
倖免	spared
倔強	stubborn
倒退	backsliding
倒車	reversing
倒掉	drained
倒彩	hooting
倒塌	collapsed
倒台	downfall
倒下	topples
個股	stocks
個月	months
個人	personal
個人	individual
倉庫	warehouse
倉庫	storehouses
俯瞰	overlooking
俯瞰	overlook
修飾	qualify
修補	patched
修補	mending
修補	mend
修理	repair
修正	correcting
修正	corrected
修改	modify
修改	amend
修復	repairing
修復	repaired
修剪	trimmed
修剪	trim
修剪	pruning
修剪	pruned
修剪	prune
信託	trusts
信號	signal
信用	credit
信息	message
信息	information
信心	confident
信徒	follower
信徒	believers
信徒	believer
信使	messenger
信任	trusted
信任	confide
信仰	godliness
信仰	faith
信仰	belief
保養	maintenance
保障	safeguard
保鏢	bodyguards
保鏢	bodyguard
保釋	bail
保護	protects
保護	protection
保護	protecting
保護	protected
保護	protect
保證	warrant
保證	pledge
保證	guaranteed
保證	guarantee
保證	assuring
保證	assures
保證	assured
保證	assure
保證	assurances
保證	assurance
保衛	defend
保羅	Paul
保羅	Pau
保管	safekeeping
保管	custody
保留	retains
保留	retain
保留	reserve
保留	reservation
保留	preserve
保持	remained
保持	maintained
保持	maintain
保持	keeps
保持	keeping
保持	keep
保持	holding
保持	hold
保持	held
保存	saving
保存	saved
保存	save
保佑	bless
俘虜	captives
俘虜	captive
俄立	Oreb
俄德	Oded
促進	promotes
促進	promote
便士	pennies
侵擾	intrusion
侵占	overran
侵入	invasion
侵入	invades
侮辱	insults
侮辱	insulting
侮辱	insult
依靠	rely
依靠	depends
依靠	depend
依賴	relies
依賴	dependence
依賴	depended
依托	relying
依偎	cling
供稿	feeds
供應	supplying
供應	supply
供應	supplied
供應	serves
供奉	enshrined
供品	offerings
例子	examples
例外	exceptions
例外	exception
來襲	struck
來源	sources
來人	bearer
來了	came
使者	messengers
使節	envoys
使用	uses
使用	use
使徒	apostles
使徒	apostle
使命	errand
使勁	straining
使出	resorted
佯庇	Jambres
佩服	admires
佣金	commission
你的	yours
你的	your
你會	you'll
你好	hello
作證	testifying
作證	testify
作證	testifies
作證	testified
作者	author
作物	crops
作物	crop
作弊	cheating
作弊	cheat
作家	writer
作孽	evildoers
作品	works
佘山	Sheshan
何薩	Hosah
何巴	Hobab
佔用	occupying
佔用	occupation
佔據	occupy
佔據	occupied
住處	quarters
住房	housing
住宿	lodging
住宅	residence
住宅	dwelling
低斯	Kedesh
低廉	cheap
低地	lowlands
低保	guaranteeing
位置	positions
位置	position
位置	location
位於	situated
位於	located
似乎	seems
似乎	seemed
似乎	seem
伸開	outstretched
伸展	stretch
伴娘	bridesmaids
伴奏	accompaniment
伴侶	mate
伴侶	companion
估計	estimation
估計	estimates
估計	estimate
伯法	Bethphage
伯山	Beth-shan
伯夙	Beth-zur
休耕	fallow
休息	rests
休息	resting
休息	rested
休息	rest
休息	repose
休息	breaks
休克	shock
伏擊	waylay
伏擊	ambushes
伏擊	ambush
伊隆	Elon
伊蘭	Eran
伊法	ephah
伊弗	Ephron
伊康	Iconium
企業	businesses
任那	Imna
任性	wayward
任命	appoints
任命	appointing
任命	appointed
任務	tasks
任務	task
任務	mission
任務	assignments
任何	whichever
任何	whatsoever
任何	any
仲春	midspring
以琳	Elim
以法	Ephrathah
以東	Idumea
以東	Edomites
以東	Edomite
以東	Edom
以掃	Esau
以拉	Elah
以弗	Epher
以巴	Ebal
以太	Ittai
以力	Erech
以前	previous
以前	formerly
以倘	Etham
以來	since
以下	following
以上	above
代表	represents
代表	representing
代表	represented
代表	representatives
代表	representative
代表	represent
代表	delegates
代表	behalf
代理	agents
代替	instead
代幣	token
付款	payment
付款	paying
他轄	Tahash
他納	Taanach
他的	his
他瑪	Ithamar
他施	Tarshish
他拉	Terah
他哈	Tahath
他們	they
他們	them
仍然	still
介紹	presentation
介紹	introduction
介紹	introduced
今晚	tonight
今天	today
仇敵	haters
仁慈	mercifully
仁慈	merciful
什麼	what
什麼	anything
人類	mankind
人類	humans
人造	man-made
人質	hostages
人群	throng
人群	populations
人群	crowds
人群	crowd
人的	human
人物	figures
人性	humanity
人口	population
人們	peoples
亮度	brightness
亭拿	Timnah
享受	enjoys
享受	enjoyment
享受	enjoying
享受	enjoyed
亦迦	Iscah
交錯	staggered
交配	mating
交通	traffic
交貨	delivery
交融	mingle
交織	interwoven
交替	alternating
交易	transaction
交易	trades
交易	traded
交易	deals
交易	dealings
交易	dealing
交換	exchanged
交換	exchange
交手	grips
交往	intercourse
交叉	cross
交付	delivering
交付	delivered
交付	deliver
亞麻	flax
亞雅	Aiah
亞錄	Alush
亞述	Assyrians
亞述	Assyrian
亞述	Assyria
亞述	Asshur
亞軍	runners
亞谷	Akkub
亞衲	Anakites
亞蘭	Arameans
亞蘭	Aramean
亞蘭	Aram
亞薩	Asaph
亞薛	Asiel
亞萊	Ahlai
亞羅	Aroer
亞米	Amittai
亞當	Adam
亞略	Arioch
亞甲	Agag
亞瑪	Amaziah
亞瑪	Amasai
亞瑪	Amariah
亞瑪	Amalekites
亞瑪	Amalek
亞現	Ahian
亞特	Ater
亞洲	Asia
亞比	Abishag
亞曼	Amam
亞斯	Asriel
亞摩	Almodad
亞拿	Anah
亞拉	Arah
亞所	Azor
亞惜	Assir
亞悉	Azel
亞弗	Aphek
亞幹	Achan
亞希	Ahikam
亞大	Adah
亞哈	Ahab
亞吉	Achish
亞勒	Athlai
亞別	Abiel
亞倫	Aaron
五面	five-sided
五子	Abital
五十	fifty
二等	second-class
二月	February
二十	twenty
事項	matters
事故	accident
事情	thing
事實	facts
事實	fact
事務	affairs
事務	affair
事件	incident
事件	happening
事件	events
事件	event
了解	understood
亂花	squandering
亂石	stoning
亂堆	huddle
亂兵	marauders
亂兵	looters
乾草	hay
乾癟	shriveled
乾涸	dried-up
乾枯	withered
乾杯	cheers
乾旱	drought
乾旱	arid
乾了	dries
乳香	frankincense
乳房	breasts
乳房	breast
也許	perhaps
也許	maybe
也不	nor
也不	neither
乞討	begging
乞求	begs
乞丐	beggars
乞丐	beggar
九月	September
九十	ninety
乘以	multiplied
乖乖	obediently
之間	between
之後	afterward
之前	preceded
之前	before
乃縵	Naaman
主題	subjects
主辦	host
主要	principal
主要	prime
主要	main
主管	responsible
主權	sovereignty
主權	dominion
主持	presided
主持	preside
主持	officiate
主張	advocate
主導	guiding
主動	driving
主人	masters
串起	strung
中間	midst
中間	middle
中途	midway
中繼	relay
中秋	midautumn
中毒	poisoning
中毒	poisoned
中心	centers
中心	centered
中年	midlife
中央	central
中央	center
中午	noontime
中午	noon
中介	mediates
中介	intermediary
並肩	alongside
丟棄	discarding
丟棄	discarded
丟棄	discard
丟失	lost
丘陵	hills
世界	world
世俗	worldly
世俗	secular
不靈	ineffective
不錯	nice
不足	lacking
不變	unchanging
不變	unchanged
不變	constant
不良	unhealthy
不能	shouldn't
不能	couldn't
不能	cannot
不能	can't
不羈	unruly
不純	impurity
不純	impure
不祥	ominously
不當	undeserved
不當	improper
不畏	defying
不甘	unwilling
不滿	discontented
不滅	unquenchable
不減	unabated
不淨	ungodliness
不法	lawless
不朽	undying
不朽	immortality
不會	wouldn't
不斷	unceasing
不斷	continually
不斷	ceaseless
不料	unexpectedly
不敬	irreverent
不恭	disrespectful
不怕	fearless
不快	displeased
不忠	unfaithful
不忠	faithlessness
不幸	wretchedness
不幸	misfortune
不屈	unyielding
不屈	unbending
不安	uneasy
不安	restless
不安	disturbed
不和	discord
不同	distinct
不同	differently
不同	different
不同	differ
不動	motionless
不公	unjust
不像	unlike
不停	kept
不信	unbelieving
不信	unbelievers
不信	unbeliever
不信	unbelief
不休	endlessly
不久	soon
不久	shortly
下馬	dismounted
下面	beneath
下面	below
下雨	raining
下雨	rained
下降	falls
下降	dropped
下降	drop
下降	descends
下降	descended
下降	declined
下轄	presides
下跪	kneel
下跌	tumble
下跌	fell
下調	slashed
下滑	slipped
下沉	sinking
下旨	decreed
下擺	hem
下巴	chin
下午	afternoon
上邊	upside
上調	raised
上訴	appeals
上訴	appealed
上訴	appeal
上衣	tops
上等	choicest
上當	fooled
上游	upstream
上市	public
上市	listings
上市	listed
上吊	hanged
上午	am
上升	rises
上升	risen
上升	rise
上升	ascent
上升	ascends
上升	ascending
三年	three-year
三十	thirty
丈夫	husbands
丈夫	husband
七月	July
七天	seven-day
七十	seventy
七倍	sevenfold
一起	together
一貫	persistent
一貫	consistent
一般	normally
一般	general
一致	unanimously
一致	unanimous
一致	concerted
一群	swarm
一瞥	glance
一直	continuously
一生	lifetime
一歲	yearling
一歲	one-year-old
一樣	equally
一樣	alike
一月	January
一旦	once
一把	handfuls
一扔	fling
一對	couple
一室	one-room
一定	surely
一定	necessarily
一口	morsel
一切	everything
一切	every
一個	an
一個	a
一些	some
一些	several
一世	i
龐	Pontus
龍	dragon
齒	tooth
鼬	ferret
點	spot
點	points
點	point
默	Shomer
黑	blackness
黑	blacker
麾	rejoice
麗	Rei
麈	stag
鹿	deer
鹽	salt
鸛	storks
鸛	stork
鷹	hawk
鷹	eagles
鷹	eagle
鷲	buzzard
鶻	falcon
鵜	pelican
鴻	hung
鳥	bird
魚	fish
鬼	ghosts
鬼	ghost
高	taller
高	tall
高	high
骨	bone
驢	donkeys
驢	donkey
驚	surprise
驁	untamed
騭	stallion
騎	ride
駒	foal
駐	stationed
馬	horse
香	spiced
香	scented
香	perfumed
香	incense
香	fragrant
餐	meals
餌	lure
餌	bait
餅	baking
飾	decorations
飛	fly
飛	flew
風	winds
風	wind
類	kind
顎	jaws
顎	jaw
題	question
題	inscribe
頭	heads
頭	head
領	collar
響	louder
響	loud
鞣	tanned
鞘	sheath
鞍	saddlebags
鞍	saddle
鞋	shoes
面	surfaces
面	facets
靠	relied
靠	lean
靜	quieted
霸	tyrants
露	dew
霰	sleet
霜	frost
雷	thunders
雷	thunder
雲	clouds
雲	cloud
雪	snow
雨	rain
難	difficult
離	off
雞	fowl
雜	mixed
雙	doubly
雙	double
雕	carves
集	collected
隸	scribe
隱	hidden
陪	accompany
除	except
陡	steep
降	descending
附	attached
陀	Netophathite
關	close
閾	threshold
閘	floodgate
閒	idle
閃	Shem
閃	flash
門	gates
門	gate
門	doors
門	door
長	longer
長	long
鑿	chisel
鑼	gong
鐺	griddle
鐵	iron
鏢	dart
鏟	spade
鏟	shovels
鏈	chains
鏈	chain
鎮	town
鎖	locks
鎖	lock
鍵	key
鍵	bond
鍛	Wrought
鍋	pot
鍋	pans
錯	wrongly
錫	tin
錨	anchors
錨	anchor
錢	money
鋸	saws
鋸	saw
鋤	hoe
銷	pin
銥	Ir
銅	copper
銀	silver
鉤	hook
鉛	lead
鉗	tongs
鈸	cymbals
鈸	cymbal
針	needle
釘	pegs
釘	nailing
釘	nailed
釘	nail
金	gold
量	amounts
量	amount
重	weighty
重	weighs
重	heavy
釉	glaze
醬	sauce
醫	medical
醚	Ether
醒	awoke
醉	drunken
醉	drunk
醇	Alcohol
酸	sour
酒	spirits
酒	liquor
鄰	adjacent
都	both
部	portions
部	ministry
那	that
邊	brim
邁	stride
選	selected
選	elect
選	chooses
遠	far
遠	away
遠	afar
違	disobeying
違	disobey
達	amounted
運	transported
遊	swam
週	weeks
週	week
連	connect
透	thoroughly
退	recede
追	chasing
追	chased
追	chase
迦	Gazez
迦	Gareb
迦	Gad
近	near
轡	bridle
轉	turn
轄	Ohad
轄	Kohathites
轄	Kohathite
轄	Kohath
輻	spoke
輪	wheel
輝	splendor
輝	brilliance
載	contained
輅	chariot
軸	shaft
軸	axes
軛	yokes
軛	yoke
車	carts
蹊	trod
蹊	footpath
蹄	hooves
蹄	hoof
踣	prostrate
踢	kicking
踢	kicked
踝	ankle
踏	tread
跳	jump
路	road
路	pathway
跫	trampling
跪	knelt
跪	kneeling
跛	crippled
跑	run
跑	ran
趨	hasten
趕	rush
超	super
走	walked
走	go
赫	Hittites
賺	earned
賺	earn
賣	sell
賢	virtuous
賊	thief
賀	Hor
買	bought
貢	tribute
貞	chaste
貓	cats
豺	jackals
豹	leopard
豬	swine
豬	pigs
豬	pig
豆	beans
谷	valley
讓	let
變	changed
變	becomes
讀	reads
讀	reading
讀	read
譯	interpret
譏	ridiculed
謹	solemnly
謊	lies
諾	Enoch
請	please
談	talked
調	tune
調	attune
課	lesson
誰	whom
誰	whoever
誰	who
說	talking
說	spoken
說	says
說	say
說	remarked
誤	mistakenly
誚	mockers
認	disown
誇	boast
該	the
話	words
話	saying
詩	poem
試	trying
許	Hur
訖	Hul
計	counted
解	solution
角	corner
親	parent
親	dear
規	regulation
西	western
西	west
襯	lining
襚	graveclothes
褶	draped
裸	nakedness
裸	naked
裸	bare
裳	skirts
裝	loaded
裝	fitted
裂	clefts
袍	gown
袋	pouch
袋	bag
衰	fades
表	tables
表	table
衝	stormed
衝	rushing
衝	rushed
街	street
行	rows
行	row
蠟	wax
蠍	scorpion
蟲	worm
蛾	moth
蛋	eggs
蛋	egg
蛇	snakes
蛇	snake
蛇	serpents
蛇	serpent
蛆	maggots
虻	gadfly
虔	pious
蘸	dipped
蘸	dip
藤	vines
藏	tucked
藏	hiding
藏	hid
藇	fine-looking
薰	embalm
薊	thistles
薊	thistle
薄	infertile
蓬	disheveled
蓋	lid
蓋	cover
葉	lobe
葉	leaf
菊	Ammonites
菊	Ammonite
莢	pods
莖	stalk
草	grasses
草	grass
苦	hardship
苦	bitter
苠	multitude
苗	seedlings
芽	shoots
芽	buds
芽	bud
花	spends
花	spend
花	flower
船	ship
船	boats
船	boat
舵	rudders
舵	rudder
舔	licking
舔	licked
舔	lick
舍	shekels
舌	tongue
舊	old
舀	scoop
至	to
臭	stink
自	self
臟	soiled
臟	dirty
臍	navel
臂	arm
膿	pus
膏	anointed
膏	anoint
腿	legs
腿	leg
腸	intestines
腸	intestinal
腳	feet
腰	waists
腰	loins
腫	swollen
腕	wrist
腓	Philippi
腐	decayed
脹	swell
脊	ridges
脂	greased
能	capable
胎	Tyre
背	backs
胃	stomach
肩	shoulder
肢	limb
股	strands
股	ply
肝	liver
肉	meat
肉	flesh
聾	deafness
聾	deaf
聽	listening
聽	listen
聽	hear
聳	shrug
聞	smelling
聞	smell
聖	holy
耳	ear
耜	plowshare
耕	cultivated
耍	charmers
而	while
老	aged
翠	emerald
翅	winged
義	righteousness
群	flock
羊	sheep
罵	scolded
罪	sins
罪	sinfulness
罪	sin
罐	pots
罐	jar
繪	painted
繩	rope
繩	cord
繡	embroider
總	total
縈	entangles
練	practicing
練	practiced
編	compile
線	thread
線	lines
線	line
線	cords
網	nets
綏	pacifies
綁	tied
綁	strapped
絲	silk
給	giving
給	gives
給	give
給	gave
絢	decked
絢	adorned
結	Ezekiel
絆	stumbles
組	set
組	groups
組	group
細	finely
累	tired
累	exhausted
紡	spin
紗	yarn
純	pure
紊	tangled
紅	reddish
紅	red
約	approximately
系	fasten
糠	chaff
糞	dung
粗	rough
粗	coarse
米	m
籠	cage
籃	baskets
籃	basket
簽	signed
簸	winnow
簇	cluster
篾	Gomer
篩	sift
篩	sieve
節	festival
管	tubes
筋	sinews
筆	pens
笨	stupid
笑	laughs
笑	laughing
笑	laugh
竿	rod
站	station
站	stand
窯	kilns
窩	brood
窄	narrower
穿	wears
穿	wear
空	empty
穰	rang
穗	spike
種	kinds
稅	taxes
稅	tax
移	shifting
秩	rank
秤	scales
租	rented
租	lease
秕	husks
科	branch
禿	bald
禮	officiating
禮	Eli
禁	endures
票	ticket
神	gods
神	god
祖	ancestral
礦	mine
磨	milling
磨	mill
磚	brick
磅	pound
碼	yards
碼	yard
碟	dish
碗	bowls
碗	bowl
碎	crushed
硬	hard
硫	sulfur
砸	smashing
砧	anvil
砂	sand
石	stony
石	stone
石	Ishi
短	shorter
短	short
矛	spear
睡	slept
睚	Jair
眼	eye
眢	parched
真	truly
真	really
看	watch
看	look
省	provinces
省	province
直	directly
盲	blind
盯	stare
盤	trays
監	supervisor
盛	sung
皮	skins
皮	hides
的	of
百	hundred
白	whiter
發	rounds
登	ascend
癱	paralyzed
癮	craving
癭	gall
癤	boils
癢	itch
瘸	lame
瘦	thin
瘦	slim
瘡	sores
瘡	sore
瘋	insane
瘋	crazy
痣	moles
痣	mole
痢	dysentery
痛	bitterly
痔	piles
痂	scab
疑	doubting
疑	doubtful
畫	drawn
畫	draw
畝	acres
畚	Hod
留	stay
留	remain
界	circles
界	bound
男	male
由	consists
由	consisting
由	consisted
由	composed
甩	dumped
生	uncooked
生	fathered
甜	sweet
瓜	melons
環	ring
瑪	Shema
瑪	Mattanah
瑪	Magog
瑣	Sophereth
球	ball
珽	scepter
珥	Ner
珥	Beor
珠	beads
珊	Dishan
玲	tinkling
玩	play
率	rate
獾	badgers
獾	badger
獸	bestial
獸	beast
獵	hounding
獐	roebuck
獎	prize
猶	Jew
狼	wolves
狼	wolf
狺	snarling
狠	relentless
狗	dog
狂	mad
犁	plowed
犁	plow
物	matter
牛	oxen
牛	ox
牛	cow
牙	teeth
牌	brand
片	sheet
片	piece
片	flakes
爾	Er
爭	indisputable
爬	crawled
爬	climb
爪	claws
爛	rotten
爐	hearth
爐	furnace
營	camp
營	battalion
燒	burned
燉	stew
燈	lamp
熱	hotter
熱	hot
熱	heat
熬	boil
熟	ripen
熟	familiar
熟	cooked
熙	thriving
熊	bears
熊	bear
煩	bother
照	shines
煤	coals
焦	scorched
焦	charred
焦	burnt
無	without
烤	roasted
烤	roast
烤	grilled
烤	broiled
烤	bake
炷	candlewick
炎	inflammation
灰	ash
火	fire
灣	bay
灑	sprinkled
灑	spilled
灑	spill
濺	splash
濱	coast
濡	moisten
濕	wetness
濕	wet
潦	flooded
潑	splashed
滾	roll
滴	dripped
滴	drip
滑	slippery
滑	slip
溫	lukewarm
溪	brook
溝	trench
溝	furrows
溝	ditch
湯	soup
湖	lake
渾	muddy
渴	thirsty
渣	dregs
減	less
淺	superficial
淺	shallow
淹	drown
深	deeply
深	deep
淫	adulteries
淪	perish
淨	net
淘	winnowed
淋	drench
涼	cool
涉	ford
海	sea
海	naval
浴	bath
流	streams
流	streaming
流	stream
流	flow
活	alive
洗	washes
洗	washed
洗	wash
洗	baptize
泥	soil
泥	mud
泥	mire
泣	weeping
波	wave
泛	pan
法	law
沿	along
油	oils
油	oil
河	river
沙	sandy
沃	fertile
汽	vapor
污	defile
池	reservoir
池	pools
池	pool
汛	Rezin
汗	sweat
求	seeking
求	begged
求	beg
永	evermore
水	water
氬	Ar
氈	felt
毯	blanket
毛	hairs
毛	gross
毗	Pithon
毗	Pelatiah
比	than
毒	poison
每	per
每	each
殺	murderous
殺	kill
殆	perilous
死	dies
死	die
死	dead
歲	year-old
歪	crooked
步	step
正	positive
欠	owed
欠	owe
檢	seized
檢	examines
檉	tamarisk
機	machines
橋	bridge
樹	tree
樞	hinged
標	marked
樁	piling
樁	pile
槽	trough
槳	oars
極	utmost
極	poles
極	pole
棚	sheds
棚	shed
棘	thornbush
棒	stick
棒	rods
棉	cotton
棄	abandoned
梳	comb
梯	terraced
梁	beams
桶	bucket
桑	mulberry
框	box
根	roots
根	rooted
根	root
栓	tethered
柴	firewood
柳	willow
柱	column
查	check
柏	cypress
枝	sticks
果	avail
板	plates
板	board
杵	pestle
東	eastern
東	east
杯	cups
束	bundle
束	bunches
束	bunch
村	village
木	wooden
木	wood
期	periods
期	period
朔	Shobai
有	having
有	have
有	had
月	month
最	most
書	book
暮	twilight
暗	darker
暗	concealed
暖	warm
暈	faint
晷	sundial
晚	night
時	times
昴	Pleiades
是	yes
是	were
是	was
是	is
是	been
是	be
是	are
星	star
早	early
旗	flags
旗	flag
旅	trip
旁	beside
新	newly
新	newer
新	new
斑	spotted
數	number
敲	knock
敢	dares
敢	dared
敢	dare
教	teaches
教	teach
教	taught
放	put
攪	stirs
攥	clutched
攄	Unwrap
擺	slew
擰	wring
擦	wiping
擦	rubbing
擦	rubbed
擠	squeeze
擠	huddled
擠	crowded
擔	Dan
撬	prying
撬	pry
撒	Zacchaeus
撒	sprinkle
搶	snatching
搶	rob
搖	shake
揮	wield
握	grip
換	changers
插	insert
揉	kneading
揉	kneaded
揉	knead
推	pushes
推	pushed
推	push
掛	hanging
掛	hang
掃	sweep
捻	twist
捧	exalt
捕	catching
挖	dug
挖	digs
挖	dig
挑	pick
按	press
指	referring
拿	took
拳	punches
括	enclose
招	trick
招	Recruit
拖	dragged
拍	pat
拍	clap
拉	pulls
拉	pulling
拉	pulled
拉	pull
押	Joab
押	Admah
抹	wiped
抹	Harumaph
抹	Chemosh
抱	armful
披	unroll
折	fold
抗	resist
投	throws
投	hurl
投	cast
抓	grasping
抓	grabbing
抓	grab
把	putting
找	find
扭	wrenched
扣	clasps
扣	Buckle
扔	tossed
扔	throw
扔	threw
打	hitting
手	hands
手	handed
手	hand
戶	households
戰	warfare
或	either
戒	Harsha
我	myself
我	me
我	I'm
成	into
懾	appalled
懶	lazy
應	shall
懈	negligent
憬	awaken
憧	unsettled
憂	worries
憂	even-tempered
慰	comforted
慢	slow
慘	miserable
慘	badly
感	sense
愛	loves
愛	love
意	intended
惹	provoked
惹	provoke
想	want
想	thinks
情	passion
悼	mourn
悼	grieve
悲	sadness
您	you
悖	rebellious
悖	perverse
恨	hating
恨	hates
恨	hated
恥	dishonors
恣	pleases
恌	empty-headed
怪	blame
性	sexually
急	urgency
急	anxious
怔	terrified
怔	startled
快	quick
忤	disobedient
忙	busy
心	heart
徽	emblem
從	from
後	rear
後	hind
後	after
往	toward
強	stronger
弱	weak
弦	stringed
引	quoted
弓	bows
弓	bow
建	constructed
廠	plant
庫	storehouse
座	pedestal
店	shop
床	beds
床	bed
幹	stem
幹	dry
幹	dried
幹	doing
年	year
平	draws
幀	frames
幀	frame
帶	brought
帶	belt
帶	bands
帶	band
席	seats
師	divisions
師	division
帕	Paltiel
希	Maki
帆	sails
帆	sail
帆	foresail
布	fabric
布	cloths
布	cloth
市	city
巴	Sheba
巧	skillfully
巧	artful
巢	nests
巢	nest
州	state
川	plain
崙	Shimron
島	island
峰	peaks
峰	peak
岸	Kishi
岬	cape
岩	rock
岩	crag
岌	peril
山	mountains
山	mountain
層	layers
層	layer
屑	crumbs
屑	crumb
屋	house
屋	estates
尿	urine
尼	Shuni
尼	Hermogenes
尼	Guni
尼	Calneh
尖	tipped
尖	pointed
少	fewer
小	tiny
小	smaller
小	small
小	little
對	right
對	pairs
對	pair
專	dedicating
將	would
將	will
寶	treasured
寶	jewel
寬	wide
寫	wrote
寫	writes
寫	write
寧	rather
寡	widowed
家	home
家	domesticated
宮	palace
室	chamber
定	definite
官	officer
完	finished
完	finish
守	observe
它	it
孩	Abihail
孤	solitary
孤	orphaned
存	Cun
字	word
孕	pregnant
孔	holes
孔	hole
孔	bore
嬌	pampered
嫪	lustful
嫩	Hanun
嫩	Arnon
委	appoint
妾	concubines
妾	concubine
妒	jealous
如	as
好	well
好	we'll
好	good
她	she
奶	milks
女	female
套	sets
夾	lined
夾	clip
太	too
天	heavens
天	days
天	day
大	larger
大	large
大	great
大	bigger
大	big
夢	dreams
夜	nocturnal
夜	nights
外	outside
外	outer
外	beyond
壺	jugs
壩	dam
壞	spoiled
壞	bad
壇	altar
壁	wall
墳	grave
墓	tomb
墊	mats
墊	mat
填	fill
塚	mound
塗	smeared
塗	coated
塔	towers
塔	tower
塊	mass
塊	lump
塊	chunk
塊	blocks
塊	block
堡	fort
堆	piled
堆	heaps
堆	heap
堀	Hori
坩	crucible
坦	Nethanel
坦	Jotham
坡	slope
坑	pits
坑	pit
坐	sit
坍	Lotan
坍	Joktan
在	in
在	at
團	regiments
團	regiment
圖	fig
圓	rounded
圓	circular
園	groves
圈	turns
圈	circle
回	returned
四	four
嚼	chews
嚼	chew
嚇	scare
噸	tons
噸	ton
噴	sprinkling
噴	gushes
噴	gush
噯	Ai
噩	Og
噠	clatter
噗	puff
噓	hush
嘶	neigh
嘴	spouts
嘰	grumble
嘗	tasted
嘆	sigh
嗷	wailing
嗥	howl
嗆	choke
單	single
喪	mourning
喪	bereave
喝	drinking
喝	drink
喝	drank
喜	delight
喙	beak
喊	shout
喉	throat
啜	sip
問	asks
問	asking
問	asked
問	ask
啊	Ugh
啊	Ah
啄	peck
啃	gnawing
啃	gnaw
唱	sings
唱	sing
唱	sang
唰	Shua
唉	Alas
唄	chant
哭	cry
哨	whistle
哦	oh
哈	Haggai
哈	Ha
哈	Aha
咸	salty
咬	bite
和	sum
和	and
告	accuse
吻	snout
吻	kisses
吻	kissed
吻	kiss
吹	blown
吹	blowing
含	containing
吠	bark
吞	swallow
吞	gulp
吐	spit
名	names
同	with
合	gathers
吃	eats
吃	eating
吃	eater
吃	eat
吃	ate
叫	called
只	mere
古	ancient
口	mouth
受	subjected
去	went
去	going
去	goes
原	Hara
厚	thickest
厚	thick
卷	volume
印	impress
卡	snap
卡	engaging
南	south
半	halves
半	halfway
半	half
午	noonday
升	l
千	thousand
十	tens
十	ten
區	districts
區	district
區	areas
區	area
匿	Minnith
匯	sinks
匠	craftsman
匙	spoons
北	north
匆	hasty
包	parcel
包	pack
勻	evenly
勺	scoops
勝	wins
加	plus
加	add
力	force
劍	swords
劍	sword
劈	chop
劃	rowed
副	deputy
剪	shears
剩	remnant
剩	leftover
前	earlier
前	ago
刻	inscribed
刻	engraves
刻	engraved
刻	carved
刺	thorn
刺	sting
刺	stab
刺	prick
刷	brushes
刷	brushed
刷	brush
到	onto
刮	shaving
刮	scratch
刮	scraped
刮	scrape
別	dont
別	don't
列	columns
切	cut
分	dividing
刀	knives
刀	knife
刀	blade
出	out
凱	triumphant
凱	triumphal
冷	cold
冰	ice
冠	crowns
再	anymore
其	their
共	altogether
六	six
八	eight
內	inside
內	innermost
內	inner
光	polished
光	light
先	prior
先	ahead
僻	secluded
像	likeness
傻	foolish
傷	injury
傴	humped
催	urging
偷	steal
側	side
停	halt
做	do
假	falsely
假	false
值	values
值	value
借	lend
借	borrowed
借	borrow
倚	leaning
倔	crabby
倒	poured
倒	pour
信	letters
信	letter
保	preserving
供	offering
例	instance
例	example
例	cases
來	comes
來	come
使	make
使	bringing
何	Hosea
佔	accounted
住	staying
住	stayed
住	dwell
低	low
位	bits
位	bit
但	but
件	pieces
代	generations
代	generation
他	him
他	he
仇	hatred
仂	tithe
仁	kernels
人	persons
人	person
人	people
人	man
亮	brightest
亮	brightened
亮	bright
亭	booth
井	wells
五	five
二	two
事	things
亂	disorderly
也	also
九	nine
乘	multiply
乘	multiplies
乖	behaved
主	primary
主	master
主	lord
丸	pill
串	string
中	within
中	medium
中	during
丟	Pontius
不	weren't
不	wasn't
不	not
不	isn't
不	doesn't
不	does
不	aren't
下	underneath
下	under
下	inferior
下	down
上	upper
上	upon
上	on
三	three
七	seven
一	one